aada	w
aaliyah	w
aamu	w
aapo	m
aaren	w
aarika	w
aaro	m
aaron	m
aarre	m
aartrude	w
aatos	m
aatto	m
ab	m
aba	w
abaddon	m
abagael	w
abagail	w
abba	m
abban	m
abbas	m
abbe	b
abbey	b
abbi	w
abbie	b
abbigail	w
abbot	m
abbott	m
abby	b
abbye	w
abdel	m
abdelkrim	m
abdi	m
abdiel	m
abdul	m
abdulbaki	m
abdulkadir	m
abdullah	m
abdurrahim	m
abdurrahman	m
abe	m
abebi	w
abednego	m
abejundio	m
abel	m
abelard	m
abelina	w
abeu	m
abey	b
abidan	m
abie	m
abiel	m
abigael	w
abigail	w
abigale	w
abijah	m
abilene	w
abimael	m
abina	w
abiona	b
abira	w
abiram	m
abisai	m
abishag	w
abishai	m
abital	w
abmaba	w
abner	m
abra	w
abraham	m
abrahan	m
abram	m
abramo	m
abran	m
abrasha	m
abraxas	m
abril	w
absalom	m
absalon	m
acacia	w
acacio	m
acacius	m
acalia	w
acantha	w
acar	m
achaicus	m
achan	m
achaz	m
achill	m
achilles	m
achilléas	m
achim	m
achmed	m
ackerley	m
ackley	m
ad	m
ada	b
adah	w
adair	m
adalbert	m
adalet	w
adalia	w
adaline	w
adalwin	m
adam	m
adamantía	w
adamina	w
adamma	w
adamnan	m
adamo	m
adams	m
adamántios	m
adan	b
adara	w
adda	w
addai	m
addi	w
addia	w
addie	b
addison	b
addo	m
addy	b
ade	m
adel	w
adela	w
adelaida	w
adelaide	w
adelbert	m
adele	w
adelgunde	w
adelheid	w
adelice	w
adelina	w
adelind	w
adelinde	w
adeline	w
adella	w
adelle	w
adelmus	m
adelphia	w
adelphos	m
adem	m
ademia	w
aden	m
adena	w
aderes	w
adesina	w
adey	w
adham	m
adi	w
adia	w
adiana	w
adie	w
adigüzel	m
adil	m
adile	w
adina	w
adine	w
adino	m
adiran	m
adis	m
aditya	m
adiva	w
adla	w
adlai	m
adleida	w
adler	m
adlesha	w
adleta	w
adley	m
admes	m
admon	m
adnan	m
ado	m
adolf	m
adolfine	w
adolfo	m
adolph	m
adolphe	m
adolpho	m
adolphus	m
adom	m
adon	m
adoncia	w
adonia	w
adonijah	m
adonis	m
adora	w
adorata	w
adore	w
adoree	w
adorne	w
adran	m
adrastos	m
adrea	w
adria	w
adriaen	m
adriaens	w
adrian	b
adriana	w
adriane	w
adrianna	w
adrianne	w
adriano	m
adrianí	w
adrianós	m
adriel	m
adrien	m
adriena	w
adrienne	w
adrik	m
adviga	w
adviye	w
adya	w
adám	m
adèle	w
adélaïde	w
aegidius	m
aeneas	m
aenne	w
aeriel	w
aeriela	w
aeriell	w
aesop	m
aetos	m
afanasiia	w
afanasiya	w
afet	w
afife	w
afimia	w
afina	w
afitap	w
afonaseva	w
afra	w
afric	w
afrodita	w
afsar	m
afton	w
ag	w
agabo	m
agace	w
agafia	w
agafiia	w
agafiya	w
agafokliia	w
agafonika	w
agafya	w
agamemnon	m
agamémnon	m
agape	w
agapiia	w
agapito	m
agasha	w
agashka	w
agata	w
agatha	w
agathe	w
agathia	w
agatho	w
agathoklís	m
agathoníki	w
agathula	w
agathí	w
agathónikos	m
agatone	m
agelaos	m
agenor	m
aggi	w
aggie	w
aggy	w
aggélis	m
agid	m
agisílaos	m
aglaia	w
aglaida	w
aglaja	w
aglaya	w
aglaía	w
agna	w
agnella	w
agnes	w
agnese	w
agnessa	w
agnesse	w
agneta	w
agnetha	w
agnette	w
agnia	w
agnieszka	w
agniia	w
agnola	w
agnolo	m
agnès	w
agní	w
agostina	w
agostino	m
agosto	m
agrafena	w
agrafina	w
agramakova	w
agretha	w
agripena	w
agripina	w
agrippa	b
agrippina	w
agu	m
agueda	w
aguie	m
aguistin	m
aguste	m
agustin	m
agápi	w
agápios	m
ahab	m
aharon	m
ahava	w
ahearn	m
ahmad	m
ahmed	m
ahmet	m
ahmik	m
ahren	m
ahu	m
aida	w
aidan	b
aideen	w
aiden	m
aife	w
aigeus	m
aigneis	w
aigéas	m
aigéfs	m
aiko	w
aila	w
ailbert	m
aile	w
ailee	w
aileen	w
ailene	w
ailey	w
aili	w
ailina	w
ailis	w
ailsa	w
ailsun	w
ailyn	w
aime	w
aimee	w
aimelle	w
aimery	m
aimi	w
aimil	w
aimilianós	m
aimo	m
aimée	w
aimílios	m
aina	w
aindrea	w
aino	w
ainslee	w
ainsley	w
ainslie	w
ainías	m
airlia	w
aischa	w
aislinn	w
aitan	m
aitana	w
aithne	w
aitugan	w
aiyana	w
aizdiakova	w
aja	w
ajax	m
ajua	w
akaisha	w
akako	w
akando	m
akasma	w
akela	w
akello	m
akgün	m
aki	b
akil	m
akilah	w
akilina	w
akillina	w
akim	m
akin	m
akina	w
akio	m
akira	w
akiro	m
akiulina	w
akiva	w
akosua	w
akriví	w
akron	m
aksana	w
aksel	m
akseli	m
akshay	m
aksinya	w
aktan	m
aktekin	m
aku	m
akulina	w
akákios	m
al	m
aladar	m
aladin	m
alain	m
alaina	w
alaine	w
alainn	w
alair	m
alajos	m
alala	w
alamea	w
alameda	w
alan	m
alana	w
alanah	w
aland	m
alane	w
alanic	m
alanis	w
alanna	w
alano	m
alanson	m
alaqua	w
alara	w
alard	m
alaria	w
alaric	m
alasa	w
alasdair	m
alastair	m
alastar	m
alasteir	m
alaster	m
alastrina	w
alavda	w
alayna	w
alayne	w
alba	w
albain	m
alban	m
albena	w
alberich	m
alberik	m
albert	m
alberta	w
albertina	w
albertine	w
alberto	m
albie	m
albin	m
albina	w
albinka	w
albinus	m
alborn	m
albrecht	m
albwin	m
alcander	m
alcina	w
alcott	m
alda	w
aldare	w
aldea	w
alden	m
aldercy	w
aldin	m
aldina	w
aldis	m
aldo	m
aldon	m
aldora	w
aldous	m
aldric	m
aldrich	m
aldridge	m
aldus	m
aldwin	m
alea	w
aleah	w
alec	m
alecia	w
aleda	w
aleece	w
aleen	w
aleister	m
alejandra	w
alejandrina	w
alejandro	m
alejoa	m
alek	m
aleka	w
aleksandar	m
aleksander	m
aleksandr	m
aleksandra	w
aleksanteri	m
aleksej	m
aleksi	m
aleksis	m
aleksy	m
aleksándra	w
alemdar	m
alen	m
alena	w
alene	w
alenica	w
alenka	w
aleron	m
alessa	w
alessandra	w
alessandro	m
alessia	w
alessio	m
aleta	w
alethea	w
aletta	w
alette	w
alev	w
alex	b
alexa	w
alexander	m
alexandr	m
alexandra	w
alexandre	m
alexandrea	w
alexandria	w
alexandrina	w
alexandrine	w
alexandro	m
alexandros	m
alexcia	w
alexei	m
alexej	m
alexi	b
alexia	w
alexina	w
alexine	w
alexio	m
alexis	b
alexius	m
alexys	w
aleyna	w
alf	m
alfeo	m
alfi	w
alfie	b
alfons	m
alfonse	m
alfonsina	w
alfonso	m
alford	m
alfred	m
alfreda	w
alfredo	m
alfy	b
alga	w
alger	m
algernon	m
algoma	w
ali	b
alia	w
alic	m
alica	w
alican	m
alice	w
alicea	w
alicia	w
alicja	w
alick	m
alida	w
alidia	w
alie	w
alijah	m
alik	m
alika	w
alike	w
alikee	w
alim	m
alima	w
alina	w
aline	w
alis	w
alisa	w
alisander	m
alisha	w
alison	w
alissa	w
alistair	m
alister	m
alisun	w
alita	w
alivia	w
alix	b
aliyah	w
aliza	w
alizée	w
aljona	w
aljosha	m
alkas	w
alkeste	w
alkibiades	m
alkibiádis	m
alkióni	w
alkmene	w
alkminió	w
alkmíni	w
alkéos	m
alkínoos	m
alla	w
allan	m
allard	m
allayne	m
alleen	w
allegra	w
allen	m
allene	w
alley	b
alleyn	m
alli	w
allianora	w
allie	b
allin	m
allina	w
allis	w
allison	w
allissa	w
allister	m
allistir	m
allix	w
allon	m
allsun	w
allx	w
ally	w
allyce	w
allyn	b
allys	w
allyson	w
alma	w
almeda	w
almeria	w
almeric	m
almeta	w
almina	w
almira	w
almire	w
almut	w
almuth	w
alodie	w
aloin	m
alois	m
aloise	w
aloisia	w
alon	m
alona	w
alondor	m
alondra	w
alonso	m
alonzo	m
aloyoshenka	m
aloys	m
aloysha	m
aloysia	w
aloysius	m
aloïs	m
alp	m
alpaslan	m
alper	m
alphaeus	m
alphard	m
alphons	m
alphonse	m
alphonso	m
alram	m
alric	m
alrigo	m
alrik	m
alrike	w
alsine	w
alston	m
alta	w
altair	m
altan	m
althea	w
aluin	m
aluino	m
alula	w
alumit	w
alva	b
alvah	m
alvan	m
alvara	w
alvaro	m
alvera	w
alverta	w
alvide	w
alvie	m
alvin	m
alvina	w
alvinia	w
alvira	w
alvis	m
alvita	w
alvy	b
alvértos	m
alwen	w
alwin	m
alwina	w
alwine	w
alwyn	m
alya	w
alyce	w
alycia	w
alyda	w
alyosha	m
alys	w
alysa	w
alyse	w
alysha	w
alysia	w
alyson	w
alyss	w
alyssa	w
alzbeta	w
alzena	w
aléka	w
alékos	m
aléxandros	m
aléxios	m
aléxis	m
alíki	w
amabel	w
amabella	w
amabelle	w
amadeo	m
amadeus	m
amadi	m
amadika	w
amadis	w
amado	m
amador	m
amaia	w
amal	m
amalaswintha	w
amaldo	m
amalea	w
amalee	w
amaleta	w
amalia	w
amalie	w
amalita	w
amalle	w
amalthea	w
amalía	w
amanda	w
amandi	w
amandie	w
amandine	w
amando	m
amandus	m
amandy	w
amanita	w
amara	w
amarante	w
amardeo	m
amargo	w
amari	b
amariah	m
amarin	m
amarion	m
amaris	w
amaryll	w
amaryllis	w
amata	w
amato	m
amatus	m
amaya	w
amazone	w
amber	w
amberly	w
ambica	w
amble	m
ambra	w
ambrogino	m
ambrogio	m
ambroise	m
ambros	m
ambrose	b
ambrosi	m
ambrosine	w
ambrosio	m
ambrosius	m
ambur	w
amby	m
amdis	w
ame	w
amedea	w
amelde	w
amelfa	w
amelia	w
amelie	w
amelina	w
ameline	w
amelita	w
amely	w
amene	w
america	w
amerigo	m
amery	m
amethyst	w
ami	w
amica	w
amie	w
amiel	m
amii	w
amil	w
amilia	w
amin	m
amina	w
aminta	w
amir	m
amira	w
amissa	w
amistad	m
amitie	w
amittai	m
amity	w
ammamaria	w
ammiel	m
ammon	m
amnon	m
amon	m
amor	m
amorina	w
amory	m
amos	m
ampliia	w
amram	m
amsden	m
amseltraud	w
amy	w
amya	w
amye	w
amánta	w
amédé	m
amédée	m
amélie	w
ana	w
anabal	w
anabel	w
anabella	w
anabelle	w
anacleto	m
anaela	w
anah	w
anahita	w
anais	w
anakin	m
analiese	w
analise	w
anallese	w
anallise	w
anan	m
ananda	m
ananias	m
anargiroúla	w
anastas	m
anastasia	w
anastasie	w
anastasiia	w
anastasija	w
anastasio	m
anastasios	m
anastasius	m
anastassia	w
anastassio	m
anastasía	w
anastásios	m
anastásis	m
anatassia	w
anath	b
anatol	m
anatola	w
anatole	m
anatoli	m
anatolii	m
anatolij	m
anatollo	m
anatolí	w
anaxagoras	m
anaximander	m
anaximenes	m
anaximénis	m
anaxímandros	m
anaya	w
anaëlle	w
anaïs	w
ancel	m
ancelin	w
ancell	m
andastra	w
andee	w
andeee	w
anderea	w
anders	m
anderson	m
andi	b
andie	b
andonis	m
andor	m
andra	w
andras	m
andre	m
andrea	w
andreana	w
andreas	m
andree	b
andreea	w
andreeva	w
andrei	b
andreiana	w
andrej	m
andres	m
andreus	m
andrew	m
andrey	m
andria	w
andriana	w
andries	m
andriette	w
andrievicha	w
andris	m
androkles	m
androklís	m
andromache	w
andromeda	w
andromáchi	w
andronikus	m
andros	m
andrus	m
andrusha	m
andrya	m
andrzej	m
andré	m
andréas	m
andrée	w
andrés	m
andríkos	m
andrónikos	m
andy	b
anechka	w
anemone	w
aneska	w
anestassia	w
anet	w
aneta	w
anett	w
anetta	w
anette	w
anevay	w
anfiia	w
anfoma	w
anfusa	w
ange	b
angel	b
angela	w
angele	w
angeli	m
angelia	w
angelica	w
angelico	m
angelika	w
angelike	w
angelikoúla	w
angelikí	w
angelina	w
angeline	w
angelique	w
angelita	w
angell	m
angelle	w
angelo	m
angelus	m
angelína	w
angie	b
angil	w
angrond	m
angus	m
angusta	w
angy	w
angéla	w
angélique	w
ania	w
anian	m
anianus	m
anica	w
aniela	w
anieli	m
anika	w
anike	w
aniki	w
animaida	w
animaisa	w
anina	w
anine	w
anisa	w
anisia	w
anisiia	w
anisiya	w
anissa	w
anisya	w
anita	w
anitchka	w
anitra	w
anitsa	w
aniweta	w
aniya	w
anizka	w
anja	w
anjali	w
anjana	w
anjanette	w
anje	w
anjela	w
anjelica	w
anjelika	w
anjella	w
anjorka	w
anjuscha	w
anka	w
anke	w
anker	m
ankica	w
ann	w
ann-kathrin	w
ann-marie	w
anna	w
anna-barbara	w
anna-diana	w
anna-diane	w
anna-lena	w
anna-lisa	w
anna-luise	w
anna-maria	w
anna-marie	w
annabal	w
annabel	w
annabela	w
annabell	w
annabella	w
annabelle	w
annabeth	w
annadiana	w
annadiane	w
annalee	w
annaleen	w
annalena	w
annalene	w
annalies	w
annaliese	w
annalisa	w
annalise	w
annamaria	w
annamarie	w
annan	m
annas	m
annastasija	w
annbritt	w
anne	w
anne-corinne	w
anne-kathrin	w
anne-katrin	w
anne-marie	b
anne-rose	w
anne-sophie	w
annecorinne	w
annedore	w
annegret	w
annegrete	w
annekatrin	w
anneke	w
annelena	w
annelene	w
anneli	w
annelie	w
annelies	w
anneliese	w
anneline	w
annelise	w
annelore	w
annely	w
annemaria	w
annemarie	w
annemie	w
annerose	w
annestine	w
annett	w
annetta	w
annette	w
anni	w
annibelle	w
annica	w
annice	w
annie	w
annik	w
annika	w
annike	w
annikki	w
annina	w
annis	w
annissa	w
annita	w
annió	w
annmaria	w
annmarie	w
annnora	w
annora	w
annoúla	w
annunciata	w
anny	w
annéta	w
anníta	w
anona	w
anouchka	w
anouk	w
anouschka	w
anoush	w
ansel	m
ansell	m
anselm	m
anselma	w
anselmo	m
ansgar	m
ansley	b
anson	m
anssi	m
anstice	b
ante	m
anteia	w
antek	m
antero	m
anthe	w
anthea	w
anthia	w
anthiathia	w
anthony	m
anthoúla	w
anthía	w
antia	w
antigone	w
antigóni	w
antin	m
antinko	m
antiochus	m
antje	w
antke	w
anto	m
antoine	m
antoinette	w
anton	m
antone	m
antonella	w
antonello	m
antonetta	w
antonette	w
antoni	m
antonia	w
antonidka	w
antonie	w
antonietta	w
antonin	m
antonina	w
antonino	m
antonio	m
antonios	m
antonita	w
antonius	m
antonoúla	w
antons	m
antony	m
antonákis	m
antonía	w
antosha	m
antriana	w
antti	m
antwan	m
antónios	m
antónis	m
anuschka	w
anushka	w
anusia	w
anwar	m
anwell	m
anwyl	m
any	m
anya	w
anyon	m
anzhela	w
anzu	w
anárgiri	w
anárgiros	m
anéstis	m
apara	w
apfiia	w
aphrodite	w
aphrodíti	w
apirka	w
apolinaria	w
apolinariia	w
apoll	m
apolline	w
apollonia	w
apoloniada	w
apolosakifa	w
aponi	w
apostolos	m
apostolía	w
apostolína	w
apostólis	m
apphia	w
appolonia	w
appolonía	w
april	w
aprilette	w
apóllon	m
apóstolos	m
aquene	w
aquilao	m
ara	b
arabel	w
arabela	w
arabele	w
arabella	w
arabelle	w
aracely	w
araceni	w
aragon	m
araldo	m
aram	m
aramil	m
araminta	w
aranka	w
aranola	w
aras	m
arash	m
aravéla	w
araxie	w
arba	w
arben	m
arbogast	m
arcadia	w
arcangelo	m
arch	m
archaimbaud	m
archambault	m
archelaos	m
archer	m
archibald	m
archibaldo	m
archibold	m
archie	m
archondís	m
archontiá	w
archontoúla	w
archontí	w
archontía	w
archontó	w
archy	m
archóntissa	w
arda	b
ardare	w
ardath	w
ardeen	w
ardelia	w
ardelis	w
ardella	w
ardelle	w
arden	w
ardene	w
ardenia	w
ardian	m
ardine	w
ardis	w
ardisj	w
ardith	w
ardon	m
ardor	m
ardra	w
arduin	m
arduino	m
ardyce	w
ardys	w
ardyth	w
are	m
arel	m
areli	m
arella	w
arely	w
aren	m
arend	m
arendt	m
ares	m
aretha	w
aretina	w
aretoúsa	w
aretí	w
argelion	m
argiroúla	w
argus	m
argyró	w
argírios	m
argíris	m
arhippa	m
arho	m
ari	m
aria	w
ariadna	w
ariadne	w
ariadní	w
arian	m
ariana	w
ariane	w
ariane petra	w
arianna	w
aribert	m
aricia	w
aricin	m
aridai	m
aridatha	w
arie	m
arieh	m
ariel	b
ariela	w
ariele	m
ariella	w
arielle	w
ariene	w
arietta	w
arif	m
arik	m
arin	m
arina	w
ario	m
arion	m
arista	w
aristarch	m
aristid	m
aristo	m
aristofánis	m
aristogénis	m
aristoménis	m
aristophanes	m
aristoteles	m
aristotle	m
aristotélis	m
aristéa	w
aristí	w
aristídis	m
aristódimos	m
ariána	w
arjen	m
arjun	m
arjuna	w
arka	w
arkadius	m
arkhipa	w
arkhippa	w
arkin	m
arlan	m
arlana	w
arlee	w
arleen	w
arlen	b
arlena	w
arlene	w
arleta	w
arlette	w
arley	m
arleyne	w
arlie	w
arliene	w
arlin	m
arlina	w
arlinda	w
arline	w
arluene	w
arly	w
arlyn	w
arlyne	w
arman	m
armand	m
armando	m
armani	w
armas	m
armin	m
armina	w
armon	m
armstrong	m
armándos	m
arn	m
arna	w
arnaldo	m
arnault	m
arnd	m
arndt	m
arne	m
arney	m
arnfried	m
arni	m
arnie	m
arnim	m
arno	m
arnold	m
arnoldo	m
arnolt	m
arnon	m
arnoud	m
arnuad	m
arnulf	m
arny	m
aroldo	m
aron	m
arpad	m
arpana	w
arpiar	m
arri	m
arrigo	m
arron	m
arsella	w
arsenio	m
arsénis	m
art	m
artair	m
arte	m
artemas	m
artemeva	w
artemiia	w
artemis	b
artemisia	w
artemisía	w
artemus	m
artemía	w
artemída	w
arther	m
arthon	m
arthur	m
artie	m
arto	m
arttu	m
artturi	m
artur	m
arturas	m
arturo	m
artus	m
arty	m
artémios	m
arv	m
arvid	m
arvie	m
arvin	m
arvo	m
arvy	m
aryan	m
aryanna	w
aryn	w
arzu	w
arístarchos	m
arístos	m
asa	b
asaf	m
asaph	m
asbjörn	m
ase	m
asena	w
asenath	w
asenette	w
asenka	w
ash	m
asha	w
ashanti	w
ashbey	m
ashby	m
ashely	w
asher	m
ashford	m
ashia	w
ashien	w
ashil	w
ashla	w
ashlan	w
ashlee	w
ashleigh	w
ashlen	w
ashley	b
ashli	w
ashlie	w
ashlin	m
ashling	w
ashly	w
ashlynn	w
ashon	m
ashton	m
ashtyn	w
ashur	m
asia	w
asimákis	m
asimína	w
asiza	w
askan	m
askitreia	w
askitriia	w
asklepios/äskulap	m
asklipiós	m
asko	m
aslan	m
asmin	w
asmund	m
aspasia	w
aspasía	w
aspen	w
assja	w
assunta	w
asta	w
astamatía	w
astera	w
asterix	m
astería	w
asteró	w
astiánax	m
astoria	w
astra	w
astrea	w
astrid	w
astrix	w
astroúla	w
astrís	m
astrítsa	w
astyanax	m
astérios	m
astéris	m
asur	m
asya	w
ata	m
atakan	m
atalanta	w
atalaya	w
atanur	m
atara	w
athalia	w
athan	m
athanasia	w
athanasios	m
athanasius	m
athanasía	w
athanásios	m
athena	w
athene	w
atheron	m
athina	w
athinagóras	m
athiná	w
athinódoros	m
athra	w
atlanta	w
atlante	w
atlas	m
atman	m
atso	m
atte	m
attila	m
attilo	m
attis	m
atty	w
aube	m
auberon	m
aubert	m
auberta	w
aubine	w
aubree	w
aubrette	w
aubrey	b
aubrie	w
aubry	b
aude	w
audi	w
audie	w
audny	w
audra	w
audre	w
audrey	w
audric	m
audrie	w
audry	w
audrye	w
audun	m
audy	w
augie	m
august	m
augusta	w
auguste	b
augustin	m
augustina	w
augustine	b
augusto	m
augustus	m
augy	m
aukusti	m
aulikki	w
aulis	m
aundrea	w
aune	w
aura	w
aure	w
aurea	w
aurek	m
aurel	b
aurelea	w
aurelia	w
aurelie	w
aurelien	m
aurelio	m
aurelius	m
auria	w
aurica	w
aurie	w
aurilia	w
aurlie	w
auroora	w
aurora	w
aurore	w
aurthur	m
aurèle	m
aurélie	w
austen	m
austin	b
austina	w
austine	w
austyn	m
autumn	w
auxilia	w
ava	w
ava-marie	w
avasa	w
avdeeva	w
avdiushka	w
avdotia	w
ave	m
avel	m
aveline	w
avena	w
avera	w
averell	m
averil	b
averill	m
avery	b
averyl	w
avessandra	w
avgerinós	m
avgerís	m
avgoustos	m
avgoustía	w
avgoustínos	m
avgoustís	m
avgoúla	w
avgusta	w
avgí	w
avi	m
avianna	w
avictor	m
avidan	m
avie	w
avigdor	m
avis	w
aviva	w
avivah	w
avram	m
avramova	w
avraám	m
avril	w
avrit	w
avrom	m
awenita	w
ax	m
axe	m
axel	m
axelia	w
axinja	w
ayame	w
ayanna	w
ayasha	w
aydan	m
ayden	m
aydin	m
ayiana	w
ayisha	w
ayita	w
ayko	m
ayla	w
ayleen	w
aylice	w
aylin	w
ayline	w
aylmar	m
aylmer	m
aymer	m
ayn	w
aynur	w
ayoka	w
ayold	m
ayse	w
aysel	w
aytaç	m
aytekin	m
ayten	w
azad	m
azalea	w
azalia	w
azarel	m
azariah	m
azaziah	m
azel	m
azisa	w
aziz	m
aziza	w
azize	w
azra	w
azrael	m
azubah	w
azura	w
azzo	m
azzurra	w
aígli	w
bab	w
babara	w
babb	w
babbette	w
babbie	w
babe	w
babett	w
babette	w
babichon	w
babirye	w
babita	w
babs	w
babsi	w
babsy	w
baby	w
bacchus	m
bacia	w
bado	m
baghira	m
bahadir	m
bahar	w
bahattin	m
bahiga	w
bahija	w
bahri	m
baialyn	w
baibichia	w
bail	m
baila	w
bailee	w
bailey	b
bailie	m
baillie	m
baily	m
baird	m
baka	w
bakarne	w
bakhteiarova	w
balala	w
balbara	w
balbina	w
balbo	m
bald	m
baldassare	m
baldassarre	m
baldovino	m
baldrick	m
balduin	m
baldur	m
baldwin	m
bale	m
balendin	m
balene	w
balian	m
balin	m
balint	m
baltasar	m
balte	m
balthasar	m
balthazar	m
baltram	m
balu	m
bambi	w
bambie	w
bamby	w
ban	m
bancroft	m
bank	m
banky	m
banning	m
baptist	m
baptiste	m
bar	m
bara	w
barabal	w
barabas	m
barak	m
baran	m
barb	w
barbabas	m
barbabra	w
barbara	w
barbara-anne	w
barbaraanne	w
barbaros	m
barbe	w
barbee	w
barberina	w
barbette	w
barbey	w
barbi	w
barbie	w
barbora	w
barbra	w
barbro	w
barby	w
barclay	m
barcley	m
bard	m
barde	m
bardo	m
bari	w
barika	w
baris	m
bariya	w
barn	m
barnabas	m
barnabe	m
barnaby	m
barnard	m
barnd	m
barnebas	m
barnett	m
barney	m
barnie	m
barny	m
baron	m
barr	m
barret	m
barrett	m
barri	m
barrie	b
barris	m
barromeo	m
barron	m
barry	b
bart	m
bartel	m
barth	m
barthasar	m
barthel	m
barthold	m
bartholemy	m
bartholomeo	m
bartholomeus	m
bartholomew	m
bartholomäus	m
bartie	m
bartlet	m
bartlett	m
bartolemo	m
bartolomeo	m
bartolomé	m
barton	m
bartram	m
barty	m
baruch	m
bary	m
baryram	m
baschir	m
base	m
basemath	w
basha	w
bashe	w
basia	w
basil	m
basile	m
basilio	m
basilissa	w
basilius	m
basima	w
basira	w
basko	m
basma	w
bassam	m
bastet	w
bastiaan	m
bastian	m
bastien	m
bastienne	w
basya	w
bat	m
batholomew	m
bathsheba	w
batista	w
batsheva	w
battista	m
batuhan	m
batya	w
baudoin	m
bavaria	w
bavol	m
bax	m
baxie	m
baxter	m
baxy	m
bay	m
bayani	m
bayard	m
baylee	w
baylor	m
bayram	m
bazhena	w
bea	w
beacan	m
beagan	m
beale	m
bealle	m
beaman	m
bear	m
bearnard	m
beat	m
beata	w
beate	w
beath	m
beathag	w
beatrice	w
beatrisa	w
beatrix	w
beatriz	w
beatus	m
beau	m
beaufort	m
beauregard	m
bebe	w
becan	m
becca	w
beck	m
becka	w
beckah	w
becki	w
beckie	w
becky	w
bedche	w
bedelia	w
bee	w
beelzebub	m
beena	w
behiye	w
beilul	w
beitris	w
bekir	m
bekki	w
bel	w
bela	b
beldon	m
beleka	w
belen	b
belgukovna	w
belia	w
belicia	w
belina	w
belinda	w
belinde	w
belisa	w
belita	w
belka	w
bell	w
bella	w
bellanca	w
bellatrix	w
belle	w
bellina	w
bellona	w
belmin	m
belphoebe	w
belsazar	m
beltrame	m
beltran	m
beltrán	m
belukha	w
belva	w
belvia	w
bem	m
bemus	m
ben	m
ben-joshua	m
benaiah	m
bendick	m
bendicty	m
bendite	w
bendix	m
benedetta	w
benedetto	m
benedick	m
benedict	m
benedicta	w
benedicto	m
benedikt	m
benedikta	w
benediktine	w
benedita	w
benetta	w
bengt	m
bengta	w
beniamino	m
benigna	w
benigno	m
benita	w
benito	m
benjamen	m
benjamin	m
benjamine	w
benji	m
benjie	m
benjiro	m
benjy	m
benka	w
benn	m
bennet	m
bennett	m
benni	w
bennie	b
benno	m
benny	b
benoit	m
benoite	w
benoît	m
benson	m
bent	m
bente	w
bentlee	m
bentley	m
benton	m
benvenuto	m
benvy	w
benyamin	m
beowulf	m
beppe	m
beppo	m
ber	m
berat	m
beren	w
berend	m
berengar	m
berenice	w
berenike	w
beret	w
berezi	w
berfin	w
berget	w
bergliot	w
berit	w
berjouhi	w
berk	m
berkay	m
berke	m
berkel	m
berkeley	m
berker	m
berki	m
berkie	m
berkley	m
berkly	m
berky	m
berlin	w
bern	m
berna	w
bernadene	w
bernadett	w
bernadette	w
bernadina	w
bernadine	w
bernadino	m
bernard	m
bernarda	w
bernarde	w
bernardetta	w
bernardina	w
bernardine	w
bernardita	w
bernardo	m
bernarr	m
bernd	m
bernd-dieter	m
bernd-michael	m
berndt	m
berne	m
bernelle	w
bernessa	w
bernete	w
bernetta	w
bernette	w
bernfried	m
bernhard	m
bernharde	w
bernhardine	w
bernhelm	m
bernhilde	w
berni	w
bernice	w
bernie	b
bernike	w
bernise	w
bernita	w
bernt	m
bernward	m
berny	b
bero	m
berri	w
berrie	w
berrit	w
berry	w
bersh	m
bert	b
berta	w
berte	w
bertha	w
berthe	w
berthild	w
berthilde	w
berthold	m
berti	b
bertie	b
bertil	m
bertilo	m
bertina	w
bertine	w
bertold	m
bertoldo	m
bertolt	m
berton	m
bertram	m
bertrame	m
bertrand	m
bertrando	m
bertwin	m
berty	b
beryl	b
beryle	w
beryll	w
besart	m
bess	w
bessie	w
bessy	w
beth	w
bethania	w
bethanie	w
bethanne	w
bethany	w
bethel	w
bethena	w
bethesta	w
bethia	w
bethina	w
bethlehem	w
bethney	w
bethuel	m
betina	w
betony	w
betrys	w
betsey	w
betsy	w
betta	w
bette	w
bette-ann	w
betteann	w
betteanne	w
betti	w
bettina	w
bettine	w
bettino	m
betty	w
bettye	w
beulah	w
bev	b
beval	m
bevan	m
beverie	w
beverlee	w
beverley	w
beverlie	w
beverly	w
bevin	b
bevis	m
bevon	m
bevvy	w
beylke	w
beyza	w
bezruchka	w
bezubaia	w
bezui	w
biaggio	m
biagino	m
biagio	m
biana	w
bianca	w
bianka	w
biata	w
bibbie	w
bibby	w
bibbye	w
bibi	w
bibiana	w
bibiane	w
bibieno	m
bibishkina	w
bice	w
bidane	w
biddie	w
biddy	w
bidelia	w
bidget	w
bienvenida	w
biiata	w
bijou	w
bil	m
bilal	m
bilhah	w
bili	w
biljana	w
bill	b
billi	w
billie	b
billy	b
billye	w
bina	w
bindy	w
bine	w
bing	m
bink	m
binky	m
binni	w
binnie	w
binny	w
binsbart	m
binti	w
bionda	w
biondetta	w
birch	m
bird	w
birdie	w
birger	m
birget	w
birgid	w
birgit	w
birgitt	w
birgitta	w
birgül	w
biriuta	w
birk	m
birkita	w
birla	w
birnur	w
birol	m
biron	m
birsel	w
birsen	w
birte	w
birthe	w
biserka	w
bithia	w
bixenta	w
bjarne	m
bjorn	m
björk	w
björn	m
blaanid	w
blade	m
blaine	m
blair	b
blaire	w
blaise	m
blake	b
blakelee	w
blakeley	w
blanca	w
blanch	w
blancha	w
blanche	w
blanchette	w
blanda	w
blandine	w
blane	m
blanid	w
blanka	w
blasius	m
blausa	w
blayne	m
blaze	m
blejan	w
blenda	w
blinni	w
blinnie	w
blinny	w
bliss	w
blisse	w
blithe	w
blodeuyin	w
blodwen	w
blomma	w
blonda	w
blondell	w
blondelle	w
blondie	w
blondy	w
blossom	w
bluette	w
bluma	w
blythe	w
bo	m
boadicea	w
boas	m
boaz	m
bob	m
bob-marvin	m
bobbe	w
bobbee	w
bobbette	w
bobbi	w
bobbie	b
bobby	b
bobbye	w
bobette	w
bobina	w
bobine	w
bobinette	w
bodil	w
bodo	m
bogart	m
bogdan	m
bogdana	w
bogdashha	m
bogey	m
bogna	w
bogukhvala	w
bogumezt	w
bogumil	m
bogumila	w
boguslava	w
bohdan	m
bohdana	w
bohumile	w
bohuslava	w
boigie	m
boika	w
bojan	m
bojana	w
boje	m
bolce	w
boldina	w
bolemila	w
boleslava	w
bolgarina	w
bolgarynia	w
bolko	m
bolodenka	m
bolton	m
bona	w
bonamy	w
bonar	m
bonaventura	m
bond	m
bondie	m
bondon	m
bondy	m
bone	m
boniface	m
bonifacio	m
bonifatius	m
bonifaz	m
bonita	w
bonnee	w
bonni	w
bonnibelle	w
bonnie	w
bonny	w
booker	m
boone	m
boonie	m
boony	m
boot	m
boote	m
booth	m
boothe	m
bopha	w
bora	m
borbála	w
borchard	m
bord	m
borden	m
bordie	m
bordy	m
borg	m
borghild	w
borgny	w
boris	m
borisova	w
boriuta	w
bork	m
borkfried	m
boromil	m
boromunde	w
borromeo	m
borya	m
boryenka	m
bosco	m
bosmat	w
bosper	m
bosse	m
botan	m
boudicca	w
bourke	m
bowes	m
bowie	m
boy	m
boyce	m
boycey	m
boycie	m
boyd	m
boyka	w
bozena	w
bozhana	w
bozhitsa	w
brad	m
bradan	m
brade	m
braden	m
bradford	m
bradley	m
bradly	m
bradney	m
brady	b
bradyn	m
braeden	m
braelyn	w
bragina	w
bram	m
bran	m
brana	w
branca	w
brand	m
branda	w
brandais	w
brande	w
brandea	w
branden	m
brander	m
brandi	w
brandice	w
brandie	w
brandise	w
brandolf	m
brandon	m
brandtr	m
brandy	b
brandyn	m
branislava	w
branizlawa	w
branka	w
branko	m
brannon	m
brant	m
brantley	m
branwen	w
bratomila	w
bratromila	w
bratrumila	w
braulio	m
brava	w
braxton	m
bray	m
brayan	m
brayden	m
braydon	m
brazil	m
breana	w
breann	w
breanna	w
breanne	w
brear	w
breda	w
bree	w
breeda	w
breena	w
breezy	w
breindel	w
bren	b
brena	w
brencis	m
brenda	w
brendan	m
brenden	m
brendin	m
brendis	m
brendon	m
brends	m
brenn	w
brenna	w
brennan	m
brennen	m
brent	m
breonna	w
bret	m
brett	b
bretta	w
brew	m
brewer	m
brewster	m
bria	w
briac	m
briallen	w
brian	m
briana	w
brianna	w
brianne	w
briano	m
briant	m
brice	m
bride	w
bridget	w
bridgette	w
bridie	w
brielle	w
brien	m
brier	w
brietta	w
brig	m
brigg	m
briggs	m
brigham	m
brighton	m
brigid	w
brigida	w
brigit	w
brigita	w
brigite	w
brigitt	w
brigitta	w
brigitte	w
brina	w
briney	w
brinley	m
brinn	w
brinna	w
briny	w
brion	m
brionna	w
briony	w
brisa	w
brisco	m
brit	b
brita	w
britannia	w
britney	w
britni	w
britt	b
britta	w
brittan	w
brittaney	w
brittani	w
brittany	w
britte	w
britteny	w
brittne	w
brittney	w
brittni	w
brittny	w
brix	m
brnaba	m
brnaby	m
brock	m
brockie	m
brocky	m
brod	m
broddie	m
broddy	m
broderic	m
broderick	m
brodie	m
brody	m
brogio	m
brok	m
bron	m
bronislaw	m
bronislawa	w
bronja	w
bronnie	m
bronny	m
bronson	m
bronwen	w
bronwyn	w
brook	b
brooke	b
brooklyn	w
brooks	b
brose	m
bruce	m
brucie	m
bruis	m
bruna	w
brunella	w
brunello	m
brunette	w
brunhard	m
brunhild	w
brunhilda	w
brunhilde	w
bruni	w
brunilda	w
bruno	m
bryan	m
bryana	w
bryanna	w
bryant	m
bryanty	m
bryce	m
brycen	m
bryn	b
bryna	w
brynja	w
brynn	w
brynna	w
brynne	w
bryon	m
bryonia	w
bryony	w
bryson	m
buck	m
buckie	m
bucky	m
bud	m
budd	m
buddie	m
buddy	m
budisla	w
budizla	w
budshka	w
budska	w
buffy	w
buiron	m
bukhval	w
bunni	w
bunnie	w
bunny	w
burak	m
burch	m
burckhard	m
burg	m
burgess	m
burghard	m
burgol	m
burgundy	w
burian	m
burk	m
burkard	m
burkart	m
burke	m
burkhard	m
burkhardt	m
burkhart	m
burl	m
burlie	m
burnaby	m
burnard	m
burr	m
burt	m
burtie	m
burton	m
burty	m
buster	m
butch	m
butz	m
buz	m
byram	m
byran	m
byrann	m
byrle	m
byrom	m
byron	b
bábis	m
bärbel	w
béatrice	w
bébhionn	w
béi	w
béla	m
bénédict	m
bérénice	w
bía	w
bílis	m
bülent	m
cacilia	w
cacilie	w
cad	m
caddric	m
cade	m
cadence	w
cadeo	m
cady	w
caedmon	m
cael	m
caesar	m
cahra	w
caiaphas	m
caiden	m
cailan	m
cailla	w
caimile	w
cain	m
cainan	m
cairistiona	w
caitlin	w
caitlyn	w
caitria	w
caitrin	w
caius	m
caja	w
cajus	m
cal	b
cala	w
calandra	w
calantha	w
calder	m
caldwell	m
cale	m
caleb	m
caledonia	w
caley	w
calhoun	m
cali	w
calida	w
caligula	m
calimero	m
calina	w
calista	w
calla	w
callan	m
callean	m
calley	w
calli	w
callia	w
callida	w
callidora	w
callie	w
calliope	w
callista	w
callisto	m
callum	m
cally	w
calogera	w
calogero	m
caltha	w
calv	m
calvin	m
calvino	m
calypso	w
cam	b
camala	w
cambra	w
camden	m
camel	w
camelai	w
camella	w
camellia	w
cameron	b
camey	m
cami	w
camila	w
camile	w
camill	m
camilla	w
camille	b
camillo	m
cammi	w
cammie	w
cammy	b
campbell	m
camren	m
camryn	w
camulos	m
can	m
canace	w
canan	w
canda	w
candace	w
candi	w
candice	w
candida	w
candide	w
candidus	m
candie	w
candis	w
candra	w
candy	w
canice	w
cansel	w
cantara	w
caoimhe	w
capri	w
caprice	w
car	m
cara	w
caralie	w
carce	m
cardea	w
care	m
caren	w
carena	w
caresa	w
caressa	w
caresse	w
carey	b
cari	w
caria	w
carie	w
caril	w
carilyn	w
carin	w
carina	w
carine	w
cariotta	w
carissa	w
carita	w
caritta	w
carl	m
carl-heinz	m
carla	w
carlee	w
carleen	w
carlen	w
carlene	w
carleton	m
carley	w
carlie	b
carlin	b
carlina	w
carline	w
carling	m
carlita	w
carlo	m
carlos	m
carlota	w
carlotta	w
carlton	m
carly	b
carlye	w
carlyle	m
carlyn	w
carlynn	w
carlynne	w
carma	w
carmel	w
carmela	w
carmelia	w
carmelina	w
carmelita	w
carmella	w
carmelle	w
carmelo	m
carmen	w
carmencita	w
carmi	m
carmina	w
carmine	b
carminia	w
carmita	w
carmon	w
carna	w
carnelian	w
carney	m
carniela	w
carny	m
caro	w
carol	w
carol-jean	w
carola	w
carolan	w
carolann	w
carole	w
carolee	w
carolin	w
carolina	w
caroline	w
caroljean	w
carolus	m
carolyn	w
carolyne	w
carolynn	w
caron	w
carpus	m
carr	m
carree	w
carri	w
carrick	m
carrie	w
carrissa	w
carrol	m
carroll	b
carry	w
carson	m
carsta	w
carsten	m
cart	m
carter	m
carver	m
cary	b
caryl	b
caryn	w
casandra	w
casar	m
cascadia	w
case	m
casey	b
cash	m
casi	w
casie	w
casilda	w
casimir	m
casimiro	m
cason	m
caspar	m
casper	m
cass	b
cassandra	w
cassandre	w
cassandry	w
cassaundra	w
cassey	w
cassi	w
cassia	w
cassidy	m
cassie	b
cassiel	w
cassim	m
cassiopeia	w
cassius	m
cassondra	w
cassy	w
casta	w
castalia	w
castor	m
catalina	w
catarina	w
catava	w
cate	w
caterina	w
catha	w
catharina	w
catharine	w
cathe	w
cathee	w
catherin	w
catherina	w
catherine	w
cathi	w
cathie	w
cathleen	w
cathlene	w
cathrin	w
cathrine	w
cathryn	w
cathy	w
cathyleen	w
cathérine	w
cati	w
catia	w
catiana	w
catie	w
catina	w
catlaina	w
catlee	w
catlin	w
cato	m
caton	m
catreen	w
catrin	w
catrina	w
catrinia	w
catriona	w
catryn	w
caty	w
cavan	m
cavit	m
cay	m
caya	w
cayden	m
caye	w
cayla	w
caylan	m
caz	m
cazzie	m
cchaddie	m
ceara	w
cebrail	m
cecania	w
cecco	m
cece	m
cecelia	w
cecil	b
cecile	w
ceciley	w
cecilia	w
cecilie	w
cecilio	m
cecilius	m
cecilla	w
cecily	w
cecislava	w
ced	m
cedric	m
cedrik	m
ceil	w
celal	m
celandia	w
celandine	w
cele	w
celene	w
celesta	w
celeste	w
celestia	w
celestina	w
celestine	w
celestino	m
celestyn	w
celestyna	w
celia	w
celie	w
celina	w
celinda	w
celine	w
celinka	w
celino	m
celio	m
celissa	w
celisse	w
celka	w
cella	w
celle	w
cello	m
celso	m
cem	m
cemal	m
cemil	m
cemile	w
cendrine	w
cengiz	m
cenk	m
centa	w
cephas	m
cerelia	w
ceres	w
cesar	m
cesare	m
cesarina	w
cesarino	m
cesaro	m
cesbo	m
cesya	w
cetin	m
cevat	m
ceyda	w
ceylin	w
chad	b
chadd	m
chaddie	m
chaddy	m
chadwick	m
chaidó	w
chaika	m
chaim	m
chaitra	w
chalmers	m
chamania	w
chan	m
chana	w
chanah	w
chance	m
chancey	m
chanda	w
chandal	w
chander	m
chandler	m
chandra	w
chane	m
chaney	m
channa	w
channing	m
chantal	w
chantalle	w
chapa	w
chapman	m
charalambía	w
chariklía	w
charil	w
charin	w
charine	w
chariot	m
charis	w
charisma	w
charissa	w
charisse	w
charita	w
charito	w
charity	w
charla	w
charlean	w
charleen	w
charlena	w
charlene	w
charles	m
charley	m
charlie	m
charline	w
charlize	w
charlot	w
charlott	w
charlotta	w
charlotte	w
charlton	m
charly	m
charmain	w
charmaine	w
charmane	w
charmian	w
charmine	w
charmion	w
charo	w
charoúla	w
charyl	w
charálambos	m
charílaos	m
chas	m
chase	m
chasity	w
chastity	w
chaunce	m
chauncey	m
chauncy	m
chava	w
chaviva	w
chaya	w
chayenne	w
chayton	m
chaz	m
che	m
chebotova	w
chekhina	w
chekhyna	w
cheliadina	w
chelsae	w
chelsea	w
chelsey	w
chelsie	w
chelsy	w
chemislava	w
chen	m
chenaniah	m
chenka	w
chenoa	w
cher	w
chere	w
cherey	w
cheri	w
cherianne	w
cherice	w
cherida	w
cherie	w
cherilyn	w
cherilynn	w
cherin	w
cherise	w
cherish	w
cherlyn	w
chermina	w
chernavka	w
chernislava	w
chernka	w
cherri	w
cherrita	w
cherry	w
chery	w
cherye	w
cheryl	w
ches	m
chesislava	w
cheslav	m
cheslie	w
chesna	w
chester	m
cheston	m
chet	m
chev	m
chevalier	m
chevy	m
cheyanne	w
cheyenne	w
chi	m
chiana	w
chiara	w
chiarina	w
chiarra	w
chic	m
chick	m
chickie	b
chicky	b
chico	m
chidori	w
chika	w
chilali	w
chilenka	w
chilja	w
chilton	m
chimalis	w
chimislava	w
chiona	w
chip	m
chiquia	w
chiquita	w
chiudka	w
chivas	m
chizu	w
chlo	w
chloe	w
chloette	w
chlorinde	w
chloris	w
chloé	w
chlöe	w
chobotova	w
chocheta	w
cholena	w
chris	b
chrisovalándis	m
chrisse	m
chrissie	b
chrissy	b
christa	w
christa-maria	w
christabel	w
christabella	w
christable	w
christal	w
christalle	w
christan	w
christean	w
christel	w
christelle	w
christen	w
christi	w
christian	m
christiana	w
christiane	w
christiano	m
christie	b
christilla	w
christin	w
christina	w
christine	w
christiána	w
christl	w
christo	m
christof	m
christofer	m
christoff	m
christoffer	m
christoforo	m
christofíli	w
christofóra	w
christoper	m
christoph	m
christophe	m
christopher	m
christophorus	m
christos	m
christy	b
christye	w
christyna	w
christína	w
christódoulos	m
christóforos	m
chrisy	m
chrisóstomos	m
chrotoem	m
chrysa	w
chrysanth	m
chrysavgí	w
chrysler	w
chrysostomus	m
chrysoúla	w
chrystal	w
chryste	w
chrystel	w
chrysáfi	w
chrysánthi	w
chrísanthos	m
chrísi	w
chrístos	m
chrýsa	w
chucho	m
chuck	m
chutikan	m
chynica	w
cháris	m
ciannait	w
ciara	w
cicely	w
cicero	m
cicily	w
ciel	w
ciernislava	w
cierra	w
cihan	m
cilka	w
cilli	w
cillian	m
cilly	w
cinda	w
cindee	w
cindelyn	w
cinderella	w
cindi	w
cindie	w
cindra	w
cindy	w
cinnamon	w
cinzia	w
cipriano	m
circe	w
ciriaco	m
cirillo	m
cirilo	m
cirino	m
ciro	m
cirstoforo	m
cissiee	w
cissy	w
cita	w
citlali	w
claas	m
claiborn	m
claiborne	m
clair	b
claire	w
clara	w
clarabelle	w
clarance	m
clare	b
clarence	m
claresta	w
clareta	w
claretta	w
clarette	w
clarey	w
clari	w
claribel	w
clarice	w
clarie	w
clarina	w
clarinda	w
clarinde	w
clarine	w
clarissa	w
clarisse	w
clarita	w
clark	m
clarke	m
clary	w
claude	b
claudell	m
claudelle	w
claudetta	w
claudette	w
claudia	w
claudia-maria	w
claudian	m
claudianus	m
claudie	w
claudina	w
claudine	w
claudio	m
claudius	m
claus	m
claus-dieter	m
claus-peter	m
clavdia	w
clay	m
clayborn	m
clayborne	m
claybourne	m
clayson	m
clayton	m
clea	w
cleavland	m
clelia	w
clem	b
clemence	w
clemens	m
clement	m
clemente	m
clementia	w
clementina	w
clementine	w
clementius	m
clemmie	b
clemmy	b
cleo	w
cleon	m
cleopas	m
cleopatra	w
cleophas	m
clerc	m
clerissa	w
clerkclaude	m
cletis	m
cleto	m
cletus	m
cleve	m
cleveland	m
clevey	m
clevie	m
cliantha	w
cliff	m
clifford	m
clifton	m
clim	m
clint	m
clinton	m
clio	w
clive	m
clivia	w
clo	w
cloe	w
clopas	m
clorinda	w
cloris	w
clothild	w
clothilde	w
clotilda	w
clotilde	w
clover	w
clovis	b
cly	m
clyde	m
clyve	m
clywd	m
cläre	w
clémence	w
clément	m
cob	m
cobb	m
cobbie	m
cobby	m
coby	m
cochiti	w
codee	w
codi	b
codie	b
cody	b
cointon	m
colan	m
colas	m
colby	m
cole	m
coleen	w
coleman	m
colene	w
colet	m
coletta	w
colette	w
colgan	m
colin	m
coline	w
colleen	w
collen	w
collete	w
collette	w
collie	w
collin	m
colline	w
colly	w
colman	m
colombano	m
colombe	w
colombina	w
colombine	w
colombo	m
colon	m
colt	m
colten	m
colton	m
columbo	m
colver	m
con	b
conan	m
conant	m
conary	m
concetta	w
concettina	w
concetto	m
conchita	w
concordia	w
conn	m
connar	m
conner	m
conney	m
conni	w
connie	b
connor	m
conny	b
conor	m
conrad	m
conrade	m
conradin	m
conrado	m
conradus	m
conroy	m
consalve	m
consolata	w
constance	w
constancia	w
constancy	w
constanta	w
constantia	w
constantin	m
constantina	w
constantine	b
constantino	m
constanze	w
consuela	w
consuelo	b
consus	m
conway	m
cookie	w
coop	m
cooper	m
cora	w
corabel	w
corabella	w
corabelle	w
coral	w
coralie	w
coraline	w
coralyn	w
corban	m
corbet	m
corbett	m
corbie	m
corbin	m
corbinian	m
corby	m
corcoran	m
cord	m
cordelia	w
cordelie	w
cordell	m
cordey	w
cordi	w
cordie	b
cordula	w
cordy	b
coreen	w
corella	w
corena	w
corenda	w
corene	w
corentin	m
corentine	w
coretta	w
corette	w
corey	b
cori	b
corie	w
corilla	w
corin	m
corina	w
corine	w
corinna	w
corinne	w
coriss	w
corissa	w
corliss	w
corly	w
cormac	m
cornall	m
corneille	m
cornel	m
cornela	w
cornelia	w
cornelie	w
cornelis	m
cornelius	m
cornell	b
cornelle	w
corney	m
cornie	b
corny	b
cornélie	w
corona	w
corrado	m
correna	w
correy	b
corri	w
corrianne	w
corrie	b
corrina	w
corrine	w
corrinne	w
corry	w
cort	m
cortez	m
cortie	m
cortney	w
corty	m
coruna	w
corvin	m
corvinus	m
cory	b
cos	m
cosetta	w
cosette	w
cosima	w
cosimo	m
coskun	m
cosmas	m
cosme	m
cosmo	m
costa	m
costante	m
costantino	m
costanza	w
costanzo	m
coty	m
court	m
courtenay	w
courtland	m
courtnay	b
courtney	b
cozmo	m
craggie	m
craggy	m
craig	m
crawford	m
creigh	m
creight	m
creighton	m
crescentia	w
crescenzo	m
cressida	w
crevan	m
crichton	m
crin	w
cris	b
crispian	m
crispin	m
crissie	w
crissy	w
crista	w
cristabel	w
cristal	w
cristen	w
cristi	w
cristian	m
cristiana	w
cristiano	m
cristie	w
cristin	w
cristina	w
cristine	w
cristionna	w
cristl	w
cristobal	m
cristoforo	m
cristy	w
crocetta	w
crocifissa	w
crosby	m
cross	m
cruz	m
crysta	w
crystal	w
crystie	w
cthrine	w
cull	m
cullan	m
cullen	m
culley	m
cullie	m
cullin	m
cully	m
culver	m
cumin	m
curcio	m
curd	m
curdin	m
curr	m
curran	m
currey	m
currie	m
curry	m
curt	m
curtice	m
curtis	m
curtiz	m
cy	m
cyb	w
cybele	w
cybil	w
cybill	w
cymbre	w
cynara	w
cynde	w
cyndi	w
cyndia	w
cyndie	w
cyndy	w
cynric	m
cynthea	w
cynthia	w
cynthie	w
cynthy	w
cyprian	m
cyprienne	w
cyra	w
cyrano	m
cyrene	w
cyriac	m
cyriakus	m
cyril	m
cyrill	m
cyrilla	w
cyrille	m
cyrillus	m
cyron	m
cyrus	m
cyryn	m
cytheria	w
cyzarine	w
czar	m
czarina	w
czeimislawa	w
czeslaw	m
cäcilia	w
cäcilie	w
cäsar	m
cédric	m
céline	w
césar	m
d'arcy	m
daan	m
daba	w
dabir	m
dabria	w
dacey	w
dachan	m
dacia	w
dacie	w
dacy	w
dae	w
dael	b
daffi	w
daffie	w
daffy	w
dafne	w
dag	m
dagan	m
dagmar	w
dagna	w
dagny	b
dagobert	m
dahlia	w
daichi	m
daile	w
daisey	w
daisi	w
daisie	w
daisuke	m
daisy	w
dajana	w
dakota	b
dal	m
dale	b
dalenna	w
daley	m
dalia	w
daliah	w
dalida	w
dalila	w
dalilah	w
dalis	m
daliunda	w
dall	m
dallas	b
dalli	m
dallin	m
dallis	m
dallon	m
daloris	w
dalston	m
dalt	m
dalton	m
daly	m
dama	w
damalis	w
daman	m
damara	w
damaris	w
damaskinos	m
damasus	m
dame	m
damek	m
damian	m
damiana	w
damiano	m
damianos	m
damianós	m
damien	m
damion	m
damir	m
damita	w
damián	m
damla	w
dammo	m
damokles	m
damon	m
dan	m
dana	b
danae	w
danaila	w
dane	m
danell	w
danella	w
danello	m
danett	w
danette	w
dangelo	m
dani	b
dania	w
danica	w
danice	w
danie	m
daniel	m
daniela	w
daniele	b
daniella	w
danielle	w
danika	w
danila	w
danilo	m
danilova	w
danior	m
danit	w
danita	w
danja	w
danjana	w
danka	w
danko	m
dankrat	m
dankwart	m
danladi	m
danna	w
dannel	m
danni	w
dannie	b
danny	b
dannye	w
dano	m
dante	m
danuta	w
danya	b
danyelle	w
danyette	w
danái	w
daphene	w
daphna	w
daphne	w
daquan	m
dar	m
dara	w
daralis	w
darb	b
darbee	m
darbie	w
darbry	w
darby	b
darcee	w
darcey	w
darci	w
darcie	w
darcy	b
darda	w
dardana	w
dardanus	m
dare	m
dareen	w
dareia	w
darell	w
darelle	w
daren	m
dari	w
daria	w
darian	m
darice	w
darija	w
darill	m
darin	m
darina	w
dario	m
darion	m
daritsa	w
darius	m
dariusz	m
darja	w
darko	m
darla	w
darleen	w
darlene	w
darline	w
darlleen	w
darn	m
darnall	m
darnell	m
daromila	w
daron	b
darragh	m
darrel	m
darrell	m
darrelle	w
darren	m
darrick	m
darrin	m
darrion	m
darryl	b
darsey	w
darsie	w
dartan	m
darwin	m
darya	w
daryl	b
daryle	m
daryn	w
daryna	w
dasan	m
dasha	w
dasi	w
dasia	w
dasie	w
dasya	w
datha	w
dathan	m
datja	w
daune	w
dav	m
dave	m
daveen	w
daven	m
daveta	w
davey	m
david	m
david-levin	m
davida	w
davidde	m
davide	m
davidson	m
davie	m
davilla	w
davin	m
davina	w
davine	w
davinia	w
davion	m
davis	m
davita	w
davon	m
davorka	w
davut	m
davy	m
davyd	w
davyzha	w
davyzheia	w
dawn	w
dawna	w
dawson	m
daya	w
dayana	w
dayla	w
dayle	w
dayna	w
dayton	m
ddene	w
de	w
deacon	m
dean	m
deana	w
deandra	w
deandre	m
deane	b
deangelo	m
deanna	w
deanne	w
deasia	w
deb	w
debbi	w
debbie	w
debby	w
debee	w
debera	w
debi	w
debor	w
debora	w
deborah	w
debra	w
decca	m
deck	m
decker	m
declan	m
deda	w
dede	w
dedenia	w
dedie	w
dedra	w
dee	b
deeann	w
deeanne	w
deedee	w
dee dee	w
deena	w
deerdre	w
deeyn	w
defne	w
dehlia	w
deianira	w
deidra	w
deidre	w
deik	m
deina	w
deirdre	w
deja	w
dekava	w
dekhova	w
del	b
dela	w
delaiah	m
delainey	m
delaney	b
delano	m
delbert	m
delbin	w
delcina	w
delcine	w
delf	m
delfina	w
delfine	w
delia	w
deliane	w
delicia	w
delila	w
delilah	w
delinda	w
dell	b
della	w
delly	w
delmar	m
delmer	m
delmor	m
delmore	m
delora	w
delores	w
deloria	w
deloris	w
delphina	w
delphine	w
delphinia	w
delsin	m
delta	w
deman	m
demarcus	m
demeter	w
demetra	w
demetre	m
demetri	m
demetria	w
demetrio	m
demetris	b
demetrius	m
demi	w
demian	m
demidova	w
demosthenes	m
demott	m
dempsey	m
demyan	m
den	m
dena	w
dene	m
deni	w
denice	w
denicha	w
denies	w
denis	m
denise	w
deniz	m
denna	w
dennet	m
denney	m
denni	w
dennie	b
dennis	m
dennison	m
denny	b
denver	m
deny	w
denys	b
denyse	w
denzel	m
deo	m
deon	m
deonne	w
deonte	m
der	m
derby	m
derek	m
deretka	w
derick	m
derk	m
derlinde	w
dermot	m
derrek	m
derrick	m
derrik	m
derril	m
derron	m
derry	m
derska	w
dervilia	w
derward	m
derwin	m
derya	m
deryl	w
derzhena	w
derzhka	w
des	m
desa	w
desdemona	w
desha	w
deshawn	m
desi	m
desideria	w
desiderio	m
desirae	w
desiree	w
desiri	w
desirée	w
desmond	m
desmund	m
despa	w
despina	w
despo	w
dessa	w
desta	w
destin	m
destinee	w
destiny	w
detana	w
detava	w
detlef	m
detlev	m
dev	m
deva	w
devaki	w
devalyn	w
devan	w
devante	m
devantha	w
deven	m
devendra	w
devera	w
deverell	m
devi	w
devid	m
devin	b
devina	w
devinne	w
devka	w
devland	m
devlen	m
devlin	m
devnet	w
devochka	w
devochkina	w
devon	w
devondra	w
devonna	w
devonne	w
devonte	m
devora	w
devran	m
devy	m
devyn	b
dew	m
dewain	m
dewey	m
dewie	m
dewitt	m
de witt	m
dex	m
dexter	m
dhana	w
di	w
diahann	w
dialekti	w
diamanta	w
diamantoúla	w
diamantís	m
diamantó	w
diamond	w
dian	b
diana	w
diandra	w
diane	w
diane-marie	w
dianemarie	w
diann	w
dianna	w
diannah	w
dianne	w
diannne	w
diantha	w
diarmid	m
diarria	w
dick	m
dickie	m
dickla	w
dicky	m
didakus	m
didi	w
didier	m
dido	w
diederik	m
diederike	w
diedrich	m
diego	m
diella	w
diena	w
dierdre	w
dierk	m
dietbold	m
dieter	m
diethard	m
diethelm	m
diether	m
dietlind	w
dietlinde	w
dietmar	m
dietrich	m
dijana	w
dikana	w
dilan	m
dilara	w
dilga	w
dill	m
dillan	m
dillian	w
dillie	m
dillon	m
dilly	m
dilys	w
dima	b
dimi	w
dimitra	w
dimitri	m
dimitrios	m
dimitry	b
dimosthenis	m
dimosthénis	m
dimut	w
dimítrios	m
dimítris	m
dina	w
dinah	w
dinara	w
dinko	m
dinnie	w
dinny	w
dino	m
dinçay	m
diogenes	m
diogénis	m
diomidis	m
dion	b
dione	w
dionis	w
dionisio	m
dionne	w
dionysia	w
dionysius	m
dionysos	m
dionysus	m
dionýsis	m
dionýssis	m
dioskur	m
diotima	w
dirk	m
dirk-michael	m
disa	w
dita	w
ditmar	m
dittmar	m
divona	w
dixie	w
djamal	m
djamil	m
djamila	w
djanna	w
dmitreeva	w
dmitri	m
dmitrieva	w
dmitrovna	w
dniren	w
doanna	w
dobbin	m
dobegneva	w
dobislava	w
dobka	w
dobra	w
dobrava	w
dobravka	w
dobreva	w
dobromila	w
dobroslava	w
dobrowest	w
dobry	m
dobryna	w
doda	w
dode	w
dodi	w
dodie	w
dody	w
doe	w
dogan	m
dolf	m
doll	w
dolley	w
dolli	w
dollie	w
dolly	w
dolores	w
dolorita	w
doloritas	w
dolph	m
dom	m
doma	w
doman	m
domaslava	w
domenic	m
domenica	w
domenico	m
domeniga	w
domenik	m
domenique	m
dominga	w
domingo	m
domini	w
dominic	m
dominica	w
dominick	m
dominik	m
dominika	w
dominikus	m
dominion	m
dominique	b
domitilla	w
domka	w
domna	w
domnika	w
domnikiia	w
domnina	w
domokos	m
domona	w
domos	m
don	m
dona	w
donal	m
donald	m
donalda	w
donall	m
donalt	m
donat	m
donata	w
donatella	w
donatello	m
donatienne	w
donato	m
donatus	m
donaugh	m
donavan	m
donavon	m
donella	w
donelle	w
donelly	m
donet	m
donetta	w
donia	w
donica	w
donielle	w
donisl	m
donka	w
donn	m
donna	w
donnajean	w
donnamarie	w
donnell	m
donni	w
donnice	w
donnie	b
donny	b
donovan	m
donte	m
dooley	m
dooriya	w
dora	w
doralia	w
doralin	w
doralyn	w
doralynn	w
doralynne	w
dorcas	w
dore	b
dorea	w
doreen	w
dorelia	w
dorella	w
dorelle	w
dorena	w
dorene	w
dorett	w
doretta	w
dorette	w
dorey	b
dori	w
doria	w
dorian	b
doriano	m
dorice	w
dorie	b
dorimédon	m
dorina	w
dorinda	w
dorine	w
doris	w
dorisa	w
dorise	w
dorit	w
dorita	w
dorkas	w
dorle	w
dorlen	w
dorntrud	w
doro	w
dorofeia	w
dorofeja	w
dorolice	w
dorolisa	w
doron	m
dorota	w
dorotea	w
doroteya	w
dorothe	w
dorothea	w
dorothee	w
dorothy	w
dorothée	w
dorree	w
dorri	w
dorrie	w
dorris	w
dorrit	w
dorry	w
dorthe	w
dorthea	w
dorthy	w
dory	b
dosi	w
dosya	w
dot	w
dotan	m
doti	w
dotti	w
dottie	w
dotty	w
doug	m
dougie	m
douglas	m
douglass	m
dougy	m
dounia	w
dov	m
doy	m
doyle	m
dozene	w
dozhene	w
dracula	m
drafi	m
draga	w
dragan	m
dragica	w
draginia	w
draginja	w
drago	m
dragomir	m
dragomira	w
dragoslawa	w
dragushla	w
draia	w
drake	m
drala	w
draven	m
dre	w
dreama	w
dreddy	w
dredi	w
drees	m
drew	m
drga	w
drina	w
drinka	w
drona	w
drosida	w
dru	b
druce	m
druci	w
drucie	w
drucill	w
drucilla	w
drucy	w
drud	m
drugi	m
drusi	w
drusie	w
drusilla	w
drusy	w
druzhinina	w
dschingis	m
duana	w
duane	m
dubrava	w
dubravka	w
dud	m
dudley	m
duff	m
duffie	m
duffy	m
dugald	m
dugan	m
duilio	m
duke	m
dukey	m
dukie	m
duklida	w
duky	m
dulce	w
dulcea	w
dulci	w
dulcia	w
dulciana	w
dulcie	w
dulcine	w
dulcinea	w
dulcy	w
dulsea	w
dumaka	m
dumbo	m
dun	m
dunc	m
duncan	m
dunja	w
dunn	m
dunstan	m
dunvallo	m
dunya	w
dunyasha	w
dur	m
durand	m
durant	m
durante	m
durmus	m
dursun	m
durva	w
durward	m
dusan	m
dusca	w
duscha	w
dusha	w
dustin	m
dusty	w
dusya	w
dutch	m
duygu	b
dvora	w
dwain	m
dwana	w
dwayne	m
dwight	m
dyan	w
dyana	w
dyane	w
dyani	w
dyann	w
dyanna	w
dyanne	w
dylan	m
dylon	m
dymas	m
dymphna	w
dyna	w
dynah	w
dysis	w
dysthe	w
dáfni	w
dámis	m
démi	w
désirée	w
déspina	w
días	m
dímis	m
dímos	m
dína	w
dóra	w
dörte	w
dörthe	w
eachelle	w
eada	w
eadaoine	w
eadie	w
eadith	w
eadmund	m
eal	m
ealasaid	w
eamon	m
ean	m
earl	m
earle	m
earlie	m
early	m
eartha	w
earvin	m
easter	w
easton	m
eaton	m
eb	m
eba	w
eban	m
ebba	w
ebbo	m
eben	m
ebeneser	m
ebenezer	m
eberhard	m
eberhardt	m
eberhart	m
eberhelm	m
ebertine	w
eberto	m
ebonee	w
ebony	w
eboreus	m
ebru	w
ecatarina	w
ecatrinna	w
ece	w
echo	w
eckard	m
eckart	m
eckehard	m
eckhard	m
eckhardt	m
eckhart	m
ecrin	w
ed	m
eda	w
edala	w
edan	m
edana	w
edd	m
edda	w
eddi	b
eddie	b
eddy	b
ede	w
edee	w
edelbert	m
edelgard	w
edeline	w
edeltraud	w
edeltraut	w
edeltrud	w
eden	w
eder	m
edgan	m
edgar	m
edgard	m
edgardo	m
edi	b
edie	w
edigna	w
edik	m
edin	b
edina	w
edison	m
edit	w
edita	w
edith	w
editha	w
edithe	w
ediva	w
ediz	m
edla	w
edlin	m
edlyn	w
edmon	m
edmond	m
edmondo	m
edmund	m
edna	w
edo	m
edoardo	m
edolie	w
edom	m
edorian	m
edouard	m
edria	w
edsel	m
eduard	m
eduardo	m
eduino	m
edvard	m
edviga	w
edvige	w
edvin	m
edviva	w
edward	m
edwin	m
edwina	w
edy	w
edyth	w
edythe	w
eemeli	m
eero	m
eetu	m
efdokia	w
efe	m
efferdan	m
efferdane	w
effi	w
effie	w
effimia	w
efimia	w
efiopskaia	w
efisio	m
efraim	m
efrain	m
efrasiia	w
efrem	m
efren	m
efrosenia	w
efrossina	w
efstratía	w
efstáthios	m
efterpi	w
efthalía	w
efthimia	w
efthimios	m
efthimía	w
efthímis	m
efthýmios	m
eftychia	w
eftychía	w
egan	m
egbert	m
ege	m
eggert	m
egidio	m
egino	m
egmund	m
egon	m
egor	m
ehrenfried	m
ehrentraud	w
ehrhard	m
ehud	m
eichbart	m
eija	w
eike	b
eila	w
eileen	w
eilis	w
eillyn	w
eimile	w
eina	w
einar	m
eino	m
eirena	w
eirene	w
eisi	m
eitel	m
ekatarina	w
ekaterina	w
ekatrinna	w
ekin	w
ekkehard	m
ekkehart	m
ekrem	m
ekzuperiia	w
el	m
ela	w
elacha	w
elaina	w
elaine	w
elam	m
elana	w
elane	w
elanor	w
elanur	w
elatha	w
elayne	w
elbert	m
elberta	w
elbertina	w
elbertine	w
elbrecht	m
elda	w
eldad	m
elden	m
eldin	m
eldon	m
eldora	w
eldoris	w
eldredge	m
eldridge	m
eldrys	w
elea	w
eleanor	w
eleanora	w
eleanore	w
eleatta	w
eleazar	m
electra	w
eleen	w
eleena	w
eleftheria	w
elefthería	w
elefthérios	m
elek	m
elektra	w
elemar	m
elen	w
elena	w
elene	w
eleni	w
elenore	w
elenya	w
eleonora	w
eleonore	w
eleora	w
elessa	w
elettra	w
eleutherius	m
elfi	w
elfie	w
elfreda	w
elfrida	w
elfrieda	w
elfriede	w
elftraud	w
elfwidde	w
elga	w
elge	m
elgin	w
elgiva	w
elgor	m
eli	m
elia	b
eliaksha	w
elian	m
eliana	w
eliane	w
eliano	m
elianora	w
elianore	w
elias	m
elicia	w
elida	w
elien	w
eliette	w
eliezer	m
elif	w
eligia	w
eligio	m
eligius	m
elihu	m
elijah	m
elikonida	w
elin	w
elina	w
eline	w
elinor	w
elinore	w
eliodoro	m
eliot	m
eliphalet	m
eliphas	m
elisa	w
elisabet	w
elisabeth	w
elisabetta	w
elisava	w
elisavet	w
elisaveta	w
elischa	m
elise	w
eliseo	m
elisha	b
elisheba	w
elisheva	w
eliska	w
elissa	w
elisávet	w
elita	w
eliud	m
eliza	w
elizabet	w
elizabeth	w
elizarova	w
elizaveta	w
elka	w
elkan	m
elkana	w
elkanah	m
elke	w
ella	w
elladine	w
ellary	m
elle	w
ellen	w
ellena	w
ellene	w
ellerey	m
ellery	m
ellette	w
elli	w
ellice	w
ellie	w
ellina	w
ellinor	w
elliot	m
elliott	m
ellis	b
ellissa	w
ellmar	m
ellodie	w
ellswerth	m
ellsworth	m
ellwood	m
elly	w
ellyn	w
ellynn	w
elma	w
elmar	m
elmas	w
elmedin	m
elmer	m
elmeri	m
elmira	w
elmo	m
elmore	m
elna	w
elnar	m
elnathan	m
elno	m
elnora	w
elnore	w
elodie	w
elof	m
eloisa	w
eloise	w
elonka	w
elonore	w
elora	w
eloy	m
elphia	w
elpidio	m
elpiniki	w
elpída	w
elroy	m
elsa	w
elsbeth	w
else	w
elset	w
elsey	w
elsi	w
elsie	w
elsina	w
elsinore	w
elspeth	w
elston	m
elsu	m
elsworth	m
elsy	w
eltje	w
elton	m
elva	w
elvera	w
elvi	w
elvin	m
elvina	w
elvira	w
elvis	m
elvyn	m
elwene	w
elwin	m
elwira	w
elwood	m
elwyn	m
ely	m
elymas	m
elyn	w
elyse	w
elysee	w
elysha	w
elysia	w
elyssa	w
elzbeta	w
elzbieta	w
elzevir	m
elzhbeta	w
eléna	w
eléni	w
eléonore	w
em	b
ema	w
emalee	w
emalia	w
emano	m
emanuel	m
emanuela	w
emanuele	m
emanuelle	w
ember	w
emel	w
emelda	w
emelen	m
emelia	w
emelie	w
emelina	w
emeline	w
emelita	w
emely	w
emelyne	w
emera	w
emeram	m
emerentia	w
emerich	m
emerita	w
emerson	b
emery	m
emidio	m
emil	m
emile	m
emilee	w
emili	w
emilia	w
emilia-luise	w
emilia-sidonie	w
emilian	m
emiliana	w
emiliano	m
emilie	w
emiline	w
emilio	m
emilka	w
emily	w
emin	m
emine	w
emir	m
emirhan	m
emlen	m
emlyn	b
emlynn	w
emlynne	w
emma	w
emmalee	w
emmaline	w
emmalyn	w
emmalynn	w
emmalynne	w
emmanouíl	m
emmanuel	m
emmanuelle	w
emmeline	w
emmeran	m
emmerich	m
emmery	m
emmet	m
emmett	m
emmey	w
emmi	w
emmie	w
emmit	m
emmo	m
emmott	m
emmy	b
emmye	w
emmylou	w
emna	w
emogene	w
emory	m
emre	m
emriye	w
emry	m
emyle	w
emylee	w
ena	w
enaile	w
enak	m
endora	w
endres	m
endrik	m
enea	m
enes	m
engelbert	m
engin	m
englebert	m
engracia	w
enid	w
enie	w
enisa	w
enn	w
enna	w
ennafa	w
ennea	w
ennio	m
ennis	m
enno	m
enoch	m
enola	w
enos	m
enosh	m
enrica	w
enrichetta	w
enrico	m
enrika	w
enrique	m
enriqueta	w
ensar	m
ensio	m
enver	m
enya	w
enye	w
enzio	m
enzo	m
eoin	m
eolan	m
eolanda	w
eolande	w
epaminondas	m
epaphras	m
epestemiia	w
ephraim	m
ephrayim	m
ephrem	m
ephrosini	w
epikhariia	w
epistima	w
epona	w
eran	b
eranthe	w
erasma	w
erasmus	m
erastus	m
eray	m
ercan	m
ercole	m
erda	w
erdal	m
erdmann	m
erdmute	w
erdogan	m
erek	m
eren	m
erena	w
eretiia	w
erhan	m
erhard	m
erhardt	m
erhart	m
erianthe	w
eric	m
erica	w
erich	m
ericha	w
erick	m
ericka	w
erie	m
erifili	w
erik	m
erika	w
erin	b
erina	w
erinn	w
erinna	w
erja	w
erk	m
erkan	m
erkki	m
erko	m
erl	m
erlan	m
erland	m
erlgard	w
erlina	w
erlinde	w
erling	m
erma	w
erman	m
ermanno	m
ermelinda	w
ermenegildo	m
ermengarde	w
ermentrud	w
ermentrude	w
ermete	w
ermin	m
ermina	w
erminia	w
erminie	w
erminio	m
ermo	m
ermolina	w
erna	w
ernaline	w
ernan	m
ernbrecht	m
ernest	m
ernesta	w
ernestina	w
ernestine	w
ernestino	m
ernesto	m
ernestus	m
ernie	m
erno	m
ernst	m
ernst-august	m
ernst-dieter	m
ernst-moritz	m
ernst-otto	m
erny	m
erofili	w
erol	m
eros	m
erotiida	w
erotókritos	m
erpo	m
errick	m
errol	m
erroll	m
ersilia	w
erskine	m
ertha	w
ertugana	w
ertugrul	m
erv	m
ervin	m
erwin	m
erykah	w
eryn	w
eryx	m
erzian	m
esa	m
esad	m
esaias	m
esat	m
esau	m
esdras	m
esila	w
esineeva	w
eskarne	w
eskil	m
esko	m
esma	w
esmaria	w
esme	b
esmeralda	w
esperanza	w
espiridion	m
esra	m
essa	w
essence	w
essi	w
essie	w
essy	w
esta	w
estachio	m
esteban	m
estefania	w
estefany	w
estefanía	w
estel	w
estele	w
estell	w
estella	w
estelle	w
ester	w
esteri	w
estevan	m
esther	w
estrella	w
estrellita	w
estéban	m
eszter	w
etain	w
etan	m
etania	w
etenia	w
ethan	m
ethe	m
ethel	w
ethelbert	m
ethelda	w
ethelin	w
ethelind	w
etheline	w
ethelred	m
ethelyn	w
ethem	m
ethen	m
ethna	w
ethnea	w
ethyl	w
etienne	m
etnay	m
etta	w
etti	w
ettie	w
ettore	m
etty	w
etu	m
euafina	w
eudice	w
eudocia	w
eudokia	w
eudor	m
eudora	w
eudoxia	w
euell	m
eufemia	w
eugen	m
eugene	m
eugenia	w
eugenie	w
eugenio	m
eugenius	m
eugine	w
eugène	m
eugénie	w
eula	w
eulalia	w
eulalie	w
eulrich	m
eumenes	m
eunice	w
euphemia	w
euphemius	m
euphrasia	w
euphrosyne	w
euprakseia	w
eupraksiia	w
euridike	w
euripides	m
europa	w
eurydike	w
eusebia	w
eusebio	m
eusepia	w
eustace	m
eustachio	m
eustachus	m
eustacia	w
eustasia	w
eustathius	m
euston	m
eustorgio	m
ev	m
eva	w
eva-maria	w
eva-marie	w
evacsa	w
evadine	w
evadne	w
evaleen	w
evamaria	w
eva maria	w
evamarie	w
evan	m
evander	m
evangelia	w
evangelin	w
evangelina	w
evangeline	w
evangelos	m
evangelía	w
evania	w
evanne	w
evanova	w
evanthe	w
evanthía	w
evaristo	m
evaristus	m
evdokeia	w
evdokia	w
evdokiia	w
evdokiya	w
evdokseia	w
evdoksiia	w
evdokía	w
evdoxía	w
evdóxios	m
eve	w
eveleen	w
evelin	b
evelina	w
eveline	w
evelyn	w
evelyne	w
evemarie	w
even	m
eveny	m
everard	m
everardo	m
evered	m
everett	m
evey	w
evfaliia	w
evfrasiia	w
evfroseniia	w
evfrosinya	w
evgenia	w
evgenii	m
evgeniia	w
evgenios	m
evgeniya	w
evgenya	w
evgenía	w
evginia	w
evguenia	w
evgénios	m
evi	w
evica	w
evie	w
evin	m
evita	w
evlambia	w
evlambios	m
evonne	w
evpraksi	w
evpraksiia	w
evridíki	w
evrim	m
evripidis	m
evripídis	m
evrosena	w
evseevskaia	w
evsegniia	w
evseveia	w
evseviia	w
evstathia	w
evstoliia	w
evtropiia	w
evvie	w
evvy	w
evy	w
evyn	m
evángelos	m
ewa	w
ewald	m
ewan	m
eward	m
ewart	m
ewell	m
ewen	m
eyde	w
eydie	w
eylül	w
eymen	m
eyota	b
eyvette	w
ezechiel	m
ezekiel	m
ezequiel	m
ezgi	w
eziechiele	m
ezio	m
ezmeralda	w
ezra	m
ezri	m
ezzo	m
fabe	m
faber	m
fabi	m
fabia	w
fabian	m
fabiana	w
fabiane	w
fabiano	m
fabien	m
fabienne	w
fabio	m
fabiola	w
fabius	m
fabián	m
fabrice	b
fabrizia	w
fabrizio	m
fabrizius	m
fabron	m
fabroni	m
faddei	m
fadey	m
fadeyka	m
fadia	w
fadila	w
fadime	w
fady	m
fae	w
fahima	w
fahmida	w
fahrettin	m
fahri	m
fahriye	w
faiga	w
faina	w
fainche	w
fair	m
fairfax	m
fairlee	w
fairleigh	m
fairlie	m
fairuza	w
faith	w
faizah	w
fajra	w
fala	w
falco	m
falgun	m
falguni	w
falito	m
falk	m
falkner	m
falko	m
fallon	w
fan	w
fanaila	w
fanchette	w
fanchon	w
fancie	w
fancy	w
fanechka	w
fania	w
fanni	w
fannie	w
fanny	w
fanoúla	w
fantasia	w
fantine	w
fanya	w
far	m
fara	w
farah	w
faraji	m
faralda	w
faramund	m
farand	w
farfalla	w
farhild	w
farica	w
farida	w
fariel	m
fariha	w
fariishta	w
faris	m
farkas	m
farlay	m
farlee	m
farleigh	m
farley	m
farlie	m
farlinde	w
farly	m
farman	m
farold	m
farr	m
farra	w
farrah	w
farrand	w
farrar	m
farrel	m
farrell	m
farris	m
faruk	m
fascienne	w
fatianova	w
fatih	m
fatima	w
fatin	w
fatma	w
faulkner	m
faun	w
faunie	w
fausta	w
faustina	w
faustine	w
faustino	m
faustinus	m
fausto	m
favsta	w
fawn	w
fawne	w
fawnia	w
fax	m
faxon	m
fay	w
faydra	w
faye	w
fayette	w
fayina	w
fayme	w
fayola	w
fayra	w
fayre	w
fayth	w
faythe	w
fayza	w
fear	m
februus	m
fedele	b
fedelma	w
federica	w
federico	m
federigo	m
fedia	w
fedka	w
fedkina	w
fedon	m
fedor	m
fedora	w
fedoritsa	w
fedorka	w
fedorova	w
fedosia	w
fedosiia	w
fedosya	w
fedotia	w
fedotiia	w
fedra	w
fedya	b
fedyenka	m
feena	w
feia	w
feiniia	w
feivel	m
fekla	w
feklitsa	w
felcia	w
felecia	w
felic	m
felicdad	w
felice	b
felicia	w
feliciana	w
feliciano	m
felicidad	w
felicie	w
felicienne	w
felicio	m
felicita	w
felicitas	w
felicite	w
felicity	w
felicle	w
felike	m
feliks	m
felina	w
feline	w
felipa	w
felipe	m
felisa	w
felisha	w
felita	w
felix	m
feliza	w
felizian	m
felizio	m
felizitas	w
femi	w
femie	w
femke	w
femma	w
fenelia	w
fenella	w
fenia	w
fenja	w
fennella	w
fenngunde	w
fenton	m
feodor	m
feodora	w
feodosia	w
feodosiia	w
feoduliia	w
feofana	w
feoklita	w
feoktista	w
feona	w
feonilla	w
feopimta	w
feopista	w
feopistiia	w
feozva	w
ferd	m
ferdi	m
ferdie	m
ferdinand	m
ferdinanda	w
ferdinande	w
ferdinando	m
ferdy	m
ferenc	m
ferfufiia	w
fergus	m
ferguson	m
ferike	w
fern	w
fernand	m
fernanda	w
fernande	w
fernandina	w
fernando	m
ferne	w
feronia	w
ferran	m
ferrel	m
ferrell	m
ferris	m
ferrucio	m
ferufa	w
feruza	w
fesalonikiia	w
festus	m
fetenia	w
fetinia	w
fetiniia	w
fevronia	w
fevzi	m
fey	w
feyzi	m
fiaga	w
fiammetta	w
fiana	w
fiann	w
fianna	w
fida	w
fidan	w
fidda	w
fidel	m
fidela	w
fidelia	w
fidelio	m
fidelis	m
fidelity	w
fidelius	m
fidelma	w
fidibus	m
fidole	m
field	m
fielding	m
fields	m
fiene	w
fiera	w
fiete	m
fifi	w
fifine	w
fikret	m
filbert	m
filberte	m
filberto	m
filia	w
filiberto	m
filide	w
filikitata	w
filip	m
filipa	w
filipe	m
filipp	m
filippa	w
filippiia	w
filippo	m
filitsata	w
filius	m
filiz	w
filmer	m
filmore	m
filofei	w
filofinaia	w
filomena	w
filomeni	w
filonilla	w
filíni	w
filíppa	w
fimochka	w
fin	m
fina	w
findabhair	w
findlay	m
findley	m
fine	w
finella	w
finetta	w
finette	w
fingorn	m
finja	w
finlay	m
finley	m
finn	m
finnguala	w
finnja	w
finnley	m
finny	w
finola	w
finvarra	w
fiona	w
fionavar	w
fionn	b
fionna	w
fionnuala	w
fionnula	w
fionola	w
fiora	w
fioralba	w
fiorella	w
fiorello	m
fiorenza	w
fiorenze	w
fiorenzo	m
fioretta	w
fiorina	w
firaki	w
firenze	w
firmino	m
firutin	m
fisk	m
fitz	m
fitzgerald	m
fiva	w
fiveia	w
fizza	w
fjodor	m
flann	b
flanna	w
flannery	b
flavia	w
flavie	w
flavienne	w
flavio	m
flavius	m
flem	m
fleming	m
flemming	m
fleta	w
fletch	m
fletcher	m
fleur	w
fleuretta	w
fleurette	w
flick	w
flin	m
flinga	w
flinn	m
flint	m
flipper	m
flo	w
floella	w
floke	m
flor	w
flora	w
florance	w
flore	w
florella	w
florence	b
florencia	w
florens	m
florentia	w
florentin	m
florentina	w
florentine	w
florenz	m
florenza	w
florestan	m
floretta	w
florette	w
flori	w
floria	w
florian	m
floriana	w
floriane	w
florianne	w
floriano	m
florica	w
florida	w
florie	w
florilla	w
florin	m
florina	w
florinda	w
florine	w
floris	b
florri	w
florrie	w
florry	b
flory	b
flossi	w
flossie	w
flossy	w
flower	w
floy	w
floyd	m
flss	w
flurin	m
flurina	w
flutura	w
flynn	m
flynt	m
fodor	m
foillan	m
foimina	w
fokina	w
fokko	m
fola	w
folina	w
folker	m
folkert	m
folkus	m
folsine	w
foma	m
fomina	w
fonda	m
fons	m
fonsie	m
fonz	m
fonzie	m
forbes	m
ford	m
forest	m
forester	m
forrest	m
forrester	m
forster	m
fortuna	w
fortunata	w
fortunato	m
fortune	w
fortunio	m
foss	m
foster	m
fotina	w
fotini	w
fotiniia	w
fotiní	w
fotoú	w
fotó	w
fovro	w
fovroneia	w
fowler	m
foxy	m
fraida	w
fran	b
franca	w
francene	w
frances	w
francesca	w
francesco	m
francette	w
franchot	m
francie	w
francine	w
francis	b
francisca	w
francisco	m
franciska	w
franciskus	m
francka	w
francklin	m
francklyn	m
franco	m
francois	m
francoise	w
francyne	w
franeka	w
frangískos	m
franja	w
franjo	m
frank	m
frank-michael	m
frank-peter	m
frank-walter	m
franka	w
frankie	b
franklin	m
franklyn	m
franky	b
franni	w
frannie	b
franny	b
frans	m
franseza	w
fransisco	m
frantiska	w
frants	m
franya	w
franz	m
franz-josef	m
franz-peter	m
franz-xaver	m
franzen	m
franzi	w
franziska	w
franziskus	m
franz josef	m
françois	m
françoise	w
frasco	m
fraser	m
frasier	m
frasquito	m
frauke	w
frayda	w
fraze	m
frazer	m
frazier	m
frea	w
fred	b
freda	w
freddi	w
freddie	b
freddy	b
fredek	m
fredelia	w
frederic	m
frederica	w
frederich	m
frederick	m
fredericka	w
frederico	m
frederigo	m
frederik	m
frederika	w
frederike	w
frederique	w
fredi	b
fredia	w
frediano	m
fredo	m
fredra	w
fredric	m
fredrick	m
fredrik	m
fredrika	w
fredy	m
free	m
freedman	m
freeland	m
freeman	m
freemon	m
freemont	m
freia	w
freida	w
freja	w
fremont	m
fresco	m
freya	w
freyde	w
frida	w
frideríki	w
fridolin	m
fridtjof	m
frieda	w
friedbert	m
friede	w
friedemann	m
frieder	m
friederich	m
friedericke	w
friederika	w
friederike	w
friedhelm	m
friedhilde	w
friedhold	m
friedl	w
friedlinde	w
friedo	m
friedrich	m
friedrich-karl	m
friedrich-wilhelm	m
friedrick	m
friedrun	w
frieso	m
frigg	w
frigga	w
frigyes	m
frini	w
frithjof	m
fritz	m
fritzi	w
frolova	w
frona	w
frosiniia	w
fruma	w
fryderyka	w
frédéric	m
fróso	w
fuchur	m
fuensanta	w
fujita	w
fulbert	m
fulgenzio	m
fuller	m
fulton	m
fulvia	w
fulvio	m
fulvius	m
fumiko	w
fumnanya	w
furaha	w
furkan	m
fuscienne	w
fynn	m
fynn-connor	m
fyodor	m
fáni	w
fánis	m
fédon	m
félicien	m
félix	m
fílippos	m
fíona	w
fívi	w
fóndas	m
fótis	m
gabbey	w
gabbi	w
gabbie	b
gabby	m
gabe	m
gabey	w
gabi	b
gabie	b
gabor	m
gabriel	b
gabriela	w
gabriela maria	w
gabriele	b
gabriele rosalie	w
gabriell	w
gabriella	w
gabrielle	w
gabriellia	w
gabriello	m
gabrila	w
gabrio	m
gaby	b
gad	m
gada	w
gaddo	m
gadina	w
gae	w
gaea	w
gael	b
gaelan	m
gaetana	w
gaetano	m
gage	m
gaia	w
gaianiia	w
gaige	m
gail	b
gaila	w
gaile	m
gal	m
gala	w
galaba	w
galaktíon	m
galaktíonas	m
galasia	w
galatea	w
galatiá	w
galatía	w
galdina	w
galdino	m
gale	b
galen	m
galenka	w
galeno	m
gali	w
galilea	w
galileo	m
galina	w
galine	w
gallagher	m
gallard	m
gallo	m
gallus	m
galochka	w
galvan	m
galven	m
galvin	m
galya	w
galyna	w
galátios	m
galátis	m
galíni	w
gamaliel	m
gamana	w
gamble	m
gamze	w
gan	m
gana	w
gananiia	w
gandaza	w
gandolfo	m
ganesa	w
ganit	w
ganja	w
ganna	w
gannie	m
gannon	m
ganny	m
ganshyam	m
ganya	m
gar	m
garald	m
garbine	w
gard	m
gardener	m
gardie	m
gardiner	m
gardner	m
gardy	m
gare	m
garek	m
gareth	m
garey	m
garfield	m
garifallia	w
garik	m
garland	w
garmon	m
garner	m
garnet	w
garnett	m
garnette	w
garold	m
garrard	m
garrek	m
garret	m
garreth	m
garrett	m
garrick	m
garridan	m
garrik	m
garrison	m
garrot	m
garrott	m
garry	m
garth	m
garv	m
garvan	m
garvey	m
garvin	m
garvy	m
garwin	m
garwood	m
gary	m
garyfalliá	w
gasha	w
gaspar	m
gaspard	m
gaspare	m
gasparo	m
gasper	m
gaston	m
gastone	m
gates	w
gaudens	m
gaudenz	m
gaultiero	m
gauri	w
gauthier	m
gautier	m
gav	m
gavan	m
gaven	m
gavin	m
gavino	m
gavra	w
gavrel	m
gavrie	m
gavrielle	w
gavriilítsa	w
gavril	m
gavrilovich	m
gavrilís	m
gavriéla	w
gavriíl	m
gavríla	w
gavrílis	m
gavyn	m
gawain	m
gawein	m
gawen	m
gawrila	w
gay	b
gaye	w
gayel	w
gayelord	m
gayla	w
gayle	b
gayleen	w
gaylene	w
gayler	m
gaylor	m
gaylord	m
gaynor	b
gea	w
gearalt	m
gearard	m
gebhard	m
gedaliah	m
gedeon	m
geert	m
geerta	w
geesa	w
geiserich	m
gela	w
gelasia	w
gelja	w
geltrude	w
gelya	w
gema	w
gemariah	m
gemma	w
gena	w
gene	b
genesis	w
genest	m
geneva	w
genevieve	w
geneviève	w
genevra	w
genia	w
genka	w
genna	w
gennadi	m
gennaro	m
genni	w
gennie	w
gennifer	w
genny	w
geno	m
genoveffa	w
genovera	w
genoveva	w
genvieve	w
geoff	m
geoffrey	m
geoffry	m
georas	m
geordie	m
georg	m
george	b
georgeanna	w
georgeanne	w
georgena	w
georges	m
georgeta	w
georgetta	w
georgette	w
georgi	m
georgia	w
georgiana	w
georgianna	w
georgianne	w
georgie	b
georgieva	w
georgina	w
georgine	w
georgios	m
georgoúla	w
georgy	m
georgía	w
georgítsa	w
geppert	m
gera	b
gerakína	w
gerald	m
geralda	w
geraldine	w
gerard	m
gerarda	w
gerardo	m
gerasimos	m
gerd	m
gerda	w
gerdi	w
gerek	m
gereon	m
gerfried	m
gerhard	m
gerhardina	w
gerhardine	w
gerhardt	m
gerhart	m
gerhild	w
gerhilde	w
geri	b
gerianna	w
gerianne	w
gerick	m
gerik	m
gerion	m
gerit	b
gerladina	w
gerlind	w
gerlinde	w
gerlis	w
germain	b
germaine	b
german	m
germana	w
germano	m
germanos	m
germayne	m
germina	w
germo	m
gernot	m
gero	m
gerolamo	m
gerold	m
gerolf	m
gerome	m
geronimo	m
gerrard	m
gerret	m
gerri	b
gerrie	b
gerrik	m
gerrilee	w
gerrit	m
gerry	b
gershom	m
gerson	m
gert	b
gerta	w
gerti	w
gertie	w
gertraud	w
gertraude	w
gertraut	w
gertrud	w
gertruda	w
gertrude	w
gertrudis	w
gerty	w
gervaise	w
gervas	m
gervasio	m
gervin	m
gerwald	m
gerwig	m
gerwin	m
gery	m
gerásimos	m
gesa	w
gesche	w
gesine	w
gesthimaní	w
gethsemane	w
getraud	w
geva	w
geza	w
gezelin	m
geórgios	m
gherardo	m
ghira	w
ghislain	m
ghislaine	w
gia	w
giachetta	w
giacinta	w
giacinto	m
giacobbe	m
giacobo	m
giacomo	m
giacopo	m
giada	w
giambattista	m
giampaolo	m
giampiero	m
gian	m
giana	w
giancarlo	m
gianfranco	m
gianina	w
gianluca	m
gianluigi	m
gianmarco	m
gianmaria	m
gianna	w
gianni	m
giannina	w
giannino	m
gianpaolo	m
gianpiero	m
giasemí	w
giavani	m
gib	m
gibb	m
gibbie	m
gibby	m
gibor	m
gideon	m
gidon	m
giesela	w
giff	m
giffard	m
giffer	m
giffie	m
gifford	m
giffy	m
gigi	w
gil	m
gila	w
gilad	m
gilana	w
gilbert	m
gilberta	w
gilberte	w
gilbertina	w
gilbertine	w
gilberto	m
gilburt	m
gilda	w
gildo	m
gilemette	w
giles	m
gilgalad	m
gill	b
gilla	w
gillan	w
gilles	m
gilli	w
gillian	w
gillie	w
gilligan	w
gilly	w
gilm	m
gilvarry	m
gina	w
ginechka	w
ginelle	w
ginette	w
ginevra	w
ginger	b
ginni	w
ginnie	w
ginnifer	w
ginny	w
gino	m
ginte	w
ginton	m
gioacchino	m
gioconda	b
gioele	m
gioia	w
gion	m
giordano	m
giorgi	m
giorgia	w
giorgina	w
giorgino	m
giorgio	m
giorgís	m
giorgítsas	m
giosetta	w
giosuè	m
giovanna	w
giovannetta	w
giovanni	m
gipsy	w
giralda	w
giraldo	m
giraud	m
girolamo	m
girte	w
gisa	w
gisbert	m
gisela	w
giselbert	m
gisele	w
giselher	m
giselhold	m
giselinde	w
gisella	w
giselle	w
giselwulf	m
gislinde	w
gisselle	w
gisèle	w
gitana	w
githa	w
gitta	w
gitte	w
giuditta	w
giulia	w
giuliana	w
giuliano	m
giulietta	w
giulio	m
giurgevaia	w
giuseppa	w
giuseppe	m
giuseppina	w
giustina	w
giustino	m
giusto	m
givon	m
gizane	w
gizela	w
gizella	w
gizheurann	w
gizla	w
giánnis	m
giórgos	m
gióta	w
giótis	m
glad	w
gladi	w
gladwyn	m
gladys	w
glafira	w
glasha	w
glasny	m
glauco	m
glaukos	m
gleb	m
glebovicha	w
gleda	w
glen	b
glenda	w
glenden	m
glendon	m
glenine	w
glenn	b
glenna	w
glennie	w
glennis	w
glikeriia	w
glikeriya	w
glikería	w
gliki	w
glori	w
gloria	w
gloriana	w
gloriane	w
glory	w
glukeriia	w
glukheria	w
glyn	b
glynda	w
glynis	w
glynn	m
glynnis	w
gnni	w
godard	m
godart	m
godava	w
goddard	m
goddart	m
godeffroy	m
godeline	w
godfree	m
godfrey	m
godfry	m
godiva	w
godja	w
godwin	m
goffredo	m
gogó	w
gogós	m
golda	w
goldarina	w
goldi	w
goldia	w
goldie	w
goldina	w
goldy	w
goliath	m
golindukha	w
golo	m
goltiaeva	w
golubitsa	w
gomer	m
gonzales	m
gonzalo	m
goober	m
goran	m
goraud	m
gord	m
gordan	m
gordana	w
gorden	m
gordianus	m
gordie	m
gordislava	w
gordo	m
gordon	m
gordy	m
gorgely	m
gorislava	w
gorm	m
gormley	w
gorn	m
gorry	m
gorshedna	w
gosheven	m
gostena	w
gostenia	w
gostiata	w
gostimira	w
goswin	m
gothart	m
gottfried	m
gotthard	m
gotthilf	m
gotthold	m
gottlieb	m
gottlob	m
goulislava	w
govdela	w
govert	m
grace	b
gracia	w
gracie	w
graciela	w
gradeigh	m
gradey	m
grady	m
graehme	m
graeme	m
graham	m
graig	m
grainne	w
gram	m
gran	m
grange	m
granger	m
grania	w
grannie	m
granny	m
grant	m
grantham	m
granthem	m
grantley	m
granville	m
grata	w
gratia	w
gratian	m
gratiana	w
gravriia	w
gray	b
grayce	w
grayson	m
grazia	w
graziana	w
graziano	m
graziella	w
grazyna	w
gredel	w
greer	w
greg	m
gregg	m
greggory	m
gregoire	m
gregoor	m
gregor	m
gregori	m
gregorio	m
gregorius	m
gregory	m
grekina	w
grekinia	w
grekyna	w
grenadine	w
grenville	m
gresham	m
greta	w
gretal	w
gretchen	w
grete	w
gretel	w
grethel	w
gretl	w
gretna	w
gretta	w
grette	w
greyson	m
grid	w
grier	w
griff	m
griffie	m
griffin	m
griffith	m
griffy	m
grifina	w
grigor	m
grigoreva	w
grigorevna	w
grigori	m
grigorieva	w
grigorii	m
grigorij	m
grigórios	m
gris	m
grischa	m
griselda	w
grisha	m
grishilda	w
grissel	w
griswold	m
grit	w
griz	m
grizel	w
groben	m
grove	m
grover	m
groza	w
gruba	w
grunya	w
grusha	w
grzegorz	m
grégoire	m
guadalupe	w
gualterio	m
gudrun	w
gudula	w
guelay	w
guendolen	w
guenevere	w
guenna	w
guenter	m
guenther	m
guerino	m
guglielma	w
guglielmo	m
guglio	m
gui	w
guido	m
guilbert	m
guillaume	m
guillema	w
guillemette	w
guillermo	m
guinevere	w
guinna	w
guiseppe	m
gulliver	m
gumbald	m
gun	m
gunar	m
gunbritt	w
gunda	w
gunde	w
gundel	w
gundela	w
gundelinde	w
gundi	w
gundolf	m
gundula	w
gunhild	w
gunilla	w
gunnar	m
gunner	m
guntar	m
guntbert	m
gunter	m
gunther	m
guntis	m
guntram	m
gus	b
gusella	w
guss	m
gussi	w
gussie	w
gussy	w
gusta	w
gustaaf	m
gustaf	m
gustav	m
gustave	m
gustavo	m
gustavus	m
gusti	w
gustie	w
gustl	m
gusty	w
guthrey	m
guthrie	m
guthry	m
gutja	w
guy	m
guyapi	m
gwen	w
gwendolen	w
gwendolin	w
gwendolyn	w
gweneth	w
gwenette	w
gwenneth	w
gwenni	w
gwennie	w
gwenny	w
gwenora	w
gwenore	w
gwyneth	w
gwynne	w
gyasi	m
gylda	w
gylvana	w
gypsy	w
gyta	w
gáspár	m
géas	m
gérald	m
géraldine	w
gérard	m
gítsa	w
góni	w
göker	m
gökhan	m
gönül	w
göran	m
götz	m
gül	w
gülay	w
gülcan	m
gülistan	w
gülsen	w
gülten	w
günter	m
günther	m
gürcan	m
gürkan	m
haakon	m
habacuc	m
habakkuk	m
habakuk	m
habiba	w
hachiro	m
hackett	m
had	m
hadad	m
hadara	w
hadassa	w
hadden	m
hadelinde	w
haden	m
hades	m
hadewych	w
hadia	w
hadil	w
hadiya	w
hadjara	w
hadlee	m
hadleigh	m
hadley	b
hadria	w
hadrian	m
hadubrand	m
hadya	w
hadyn	m
haf	w
hagan	m
hagar	w
hagen	m
haggai	m
hagop	m
hahnee	m
haidar	m
haidee	w
haider	m
haifa	w
haila	w
hailee	w
hailey	b
hailie	w
haily	b
haimi	w
haizea	w
hajna	w
hajnalka	w
hajo	m
hakan	m
hakeem	m
hakim	m
hakki	m
hakon	m
hal	m
hala	w
halcyone	w
haldis	w
haldor	m
haldur	m
hale	m
haleigh	b
halette	w
haley	b
hali	w
halie	w
halil	m
halimeda	w
halina	w
halinka	w
hall	m
hallam	m
hallbjörn	m
halldor	m
halldora	w
halley	w
halli	w
hallie	w
hallsy	m
hallvard	m
hally	w
halmar	m
halona	w
halsey	m
halstein	m
halsten	m
halsy	m
haluk	m
halvar	m
halvard	m
halvdan	m
halvor	m
halyna	w
ham	m
hama	w
hamel	m
hamid	m
hamil	m
hamilcar	m
hamilton	m
hamish	m
hamit	m
hamlen	m
hamlet	m
hamlin	m
hammad	m
hammond	m
hamnet	m
hamo	m
hamon	m
hampus	m
hamza	m
hana	w
hanako	w
hananiah	m
handan	w
hande	w
hania	w
hanif	m
hanife	w
hanja	w
hank	m
hanke	m
hanna	w
hannah	w
hannchen	w
hanne	w
hanne-lore	w
hannele	w
hannelore	w
hannes	m
hanni	b
hannibal	m
hannie	w
hannis	w
hanno	b
hanns	m
hannu	m
hanny	w
hans	m
hans-adolf	m
hans-albert	m
hans-bernd	m
hans-christian	m
hans-detlef	m
hans-dieter	m
hans-dietrich	m
hans-eberhard	m
hans-erich	m
hans-friedrich	m
hans-georg	m
hans-gerd	m
hans-gerhard	m
hans-günter	m
hans-günther	m
hans-heinrich	m
hans-helmut	m
hans-henning	m
hans-herbert	m
hans-hermann	m
hans-hinrich	m
hans-joachim	m
hans-jochen	m
hans-josef	m
hans-jörg	m
hans-jürgen	m
hans-karl	m
hans-ludwig	m
hans-martin	m
hans-michael	m
hans-otto	m
hans-peter	m
hans-rainer	m
hans-rudolf	m
hans-theo	m
hans-ulrich	m
hans-uwe	m
hans-walter	m
hans-werner	m
hans-wilhelm	m
hans-willi	m
hans-wolfgang	m
hans dieter	m
hansgeorg	m
hans georg	m
hansiain	m
hansjoachim	m
hans joachim	m
hans josef	m
hansjörg	m
hans jörg	m
hansjürgen	m
hans jürgen	m
hanson	m
hans peter	m
hanspeter	m
happy	w
har	m
harad	m
harald	m
haraldur	m
harbert	m
harcourt	m
harden	m
harding	m
hardy	m
harika	w
harinder	m
harish	m
harith	m
hark	m
harlan	m
harland	m
harlen	m
harlene	w
harley	b
harli	w
harlie	w
harlin	m
harm	m
harman	m
harmkelina	w
harmon	m
harmonia	w
harmonie	w
harmony	w
harold	m
haroun	m
harp	m
harper	m
harri	b
harrie	w
harriet	w
harriett	w
harrietta	w
harriette	w
harriot	w
harriott	w
harris	m
harrison	m
harro	m
harry	m
harsha	w
harshal	m
hart	m
hartley	m
hartmann	m
hartmut	m
hartmuth	m
hartwell	m
hartwig	m
hartwin	m
haru	w
haruki	m
harun	m
harv	m
harve	m
harvey	m
harvie	m
harwell	m
harwilll	m
hasan	m
hasana	w
hasdrubal	m
hasheem	m
hashim	m
hasib	m
hasim	m
hasine	w
haskel	m
haskell	m
haslett	m
hassan	m
hasse	m
hasso	m
hastie	m
hastings	m
hasty	m
hathor	w
hatice	w
hatim	m
hatshepsut	w
hatti	w
hattie	w
hatty	w
hauke	m
haukea	w
haul	m
hausu	w
hava	w
havah	w
havard	m
havel	m
haven	b
havilah	w
havin	w
havva	w
haya	w
haydee	w
hayden	b
hayder	m
haydon	m
hayes	m
hayfa	w
haylee	w
hayleigh	w
hayley	w
haylie	w
haytham	m
hayward	m
haywood	m
hayyim	m
hazael	m
hazan	w
haze	b
hazel	b
hazlett	m
hea	w
headley	m
heall	m
heath	b
heather	w
heaven	w
heba	w
hebel	m
heber	m
hebert	m
heck	m
heckie	m
hector	m
heda	w
hedda	w
heddi	w
heddie	w
heddwyn	m
hede	w
hedeon	m
hedi	w
hedia	w
hedley	m
hedva	w
hedvig	w
hedvige	w
hedvika	w
hedwig	w
hedwiga	w
hedy	w
hefin	m
hefina	w
heida	w
heide	w
heide-marie	w
heidelinde	w
heidelore	w
heidemaria	w
heidemarie	w
heiderose	w
heidi	w
heidie	w
heidrun	w
heidtrud	w
heike	w
heikki	m
heiko	m
heiltrud	w
heilwig	w
heilyn	m
heimo	m
hein	m
heindrick	m
heiner	m
heinfried	m
heini	b
heino	m
heinrich	m
heinrick	m
heinrik	m
heinrike	w
heinz	m
heinz-dieter	m
heinz-georg	m
heinz-gerd	m
heinz-günter	m
heinz-günther	m
heinz-joachim	m
heinz-josef	m
heinz-jörg	m
heinz-jürgen	m
heinz-otto	m
heinz-peter	m
heinz-walter	m
heinz-werner	m
heinz-wilhelm	m
heinz-willi	m
heinz dieter	m
heitor	m
hektor	m
helah	w
helaina	w
helaine	w
helaku	m
helder	m
heledd	w
helen	w
helen-elizabeth	w
helena	w
helene	w
helenelizabeth	w
helenka	w
helferich	m
helfried	m
helga	w
helge	b
heli	m
helin	w
heliodoros	m
helios	m
helka	w
hella	w
helladius	m
hellen	w
helli	w
hellmut	m
hellmuth	m
helma	w
helmar	m
helmbrecht	m
helmfried	m
helmi	w
helmine	w
helmtraud	w
helmtrud	w
helmut	m
helmuth	m
heloise	w
helsa	w
helvi	w
helyn	w
hema	w
hemma	w
hemming	m
hena	w
henda	w
henderson	m
hendrick	m
hendrik	m
hendrika	w
hendrikje	w
henk	m
henka	w
henkka	m
henna	w
henner	m
hennes	m
henni	w
hennie	w
henning	m
henny	w
henri	b
henrick	m
henrie	w
henrieta	w
henrietta	w
henriette	w
henrik	m
henrika	w
henrikas	m
henrike	w
henrikki	m
henrique	m
henry	m
henryetta	w
henryk	m
henye	w
hephaestus	m
hephzibah	w
hepsie	w
hera	w
heracleitus	m
herakleides	m
herakles	m
herb	m
herbert	m
herberto	m
herbie	m
herby	m
herc	m
hercule	m
hercules	m
herculie	m
herdis	w
hereward	m
heribert	m
heriberto	m
herk	m
herkko	m
herkules	m
herleif	m
herlind	w
herlinde	w
herma	w
herman	m
hermann	m
hermann-josef	m
hermanni	m
hermann josef	m
hermanus	m
hermenegildo	m
hermes	m
hermia	w
hermie	m
hermina	w
hermine	w
herminia	w
herminio	m
herminius	m
hermione	w
hermogenes	m
hermokrates	m
hermolaos	m
hermon	m
hermosa	w
hermtje	w
hermy	m
hernan	m
hernando	m
hero	m
herod	m
herodes	m
herodion	m
herodotus	m
herold	m
heron	m
herrick	m
herrmann	m
hersch	m
herschel	m
hersh	m
hershel	m
hersilia	w
herta	w
hertha	w
hertwig	m
herve	m
hervey	m
hervé	m
herwig	m
hesekiel	m
heshel	m
hesiod	m
hesper	w
hester	w
hesther	w
hestia	w
heta	w
hetti	w
hettie	w
hetty	w
heulwen	w
hew	m
hewe	m
hewet	m
hewett	m
hewie	m
hewitt	m
heydar	m
heywood	m
hezekiah	m
hi	m
hiba	w
hieronymus	m
hilaire	m
hilargi	w
hilaria	w
hilario	m
hilarion	m
hilarius	m
hilary	b
hilbert	m
hilda	w
hildagard	w
hildagarde	w
hildburg	w
hilde	w
hildebrand	m
hildeburg	w
hildegaard	w
hildegard	w
hildegarde	w
hildegart	w
hildegund	w
hildegunde	w
hilding	m
hildred	w
hildrun	w
hildy	w
hilgert	m
hilja	w
hilka	w
hilkka	w
hilko	m
hill	m
hilla	w
hillard	m
hillary	b
hillel	m
hillery	m
hillevi	w
hilliard	m
hilliary	w
hillie	m
hillier	m
hilly	m
hillyer	m
hilma	w
hilmar	m
hilppa	w
hilton	m
hiltraud	w
hiltrud	w
hinda	w
hinezka	w
hinica	w
hinrich	m
hinrik	m
hinun	m
hinz	m
hinze	m
hiob	m
hipolito	m
hippodamia	w
hippokrates	m
hippolyt	m
hippolyta	w
hippolytos	m
hira	w
hirah	m
hiram	m
hiroki	m
hiroshi	m
hirsch	m
hirsh	m
hisham	m
hitomi	w
hizkiah	m
hjalmar	m
hjördis	w
hobard	m
hobart	m
hobey	m
hobie	m
hodawa	w
hodge	m
hoebart	m
hogan	m
hoho	m
hokolesqua	m
holden	m
holger	m
holli	w
hollie	w
hollis	b
holly	b
holly-anne	w
hollyanne	w
holm	m
holma	w
holmes	m
holpurga	w
holt	m
homa	w
homer	m
homere	m
homerus	m
honey	w
honna	w
honon	m
honor	w
honora	w
honorata	w
honoratus	m
honoria	w
honorine	w
honorius	m
honoré	m
honorée	w
honour	w
hooda	w
hope	w
hopkin	m
hora	w
horace	m
horacio	m
horand	m
horatia	w
horatio	m
horatius	m
horina	w
horst	m
horst-dieter	m
horst-günter	m
horst-peter	m
horstmar	m
hort	m
horten	m
hortense	w
hortensia	w
horton	m
horus	m
hosanna	w
hosche	w
hosea	m
hoshi	w
hostena	w
houston	m
hovhannes	m
hovsep	m
howard	m
howell	m
howey	m
howie	m
hoyt	m
hrissa	w
hruoza	w
hrvoje	m
hube	m
hubert	m
hubertine	w
huberto	m
hubertus	m
hubey	m
hubie	m
hubrecht	m
hudson	m
huey	m
huffie	m
hugh	m
hughie	m
hugibert	m
hugo	m
hugues	m
hulda	w
huldah	w
hulwema	m
humbert	m
humberto	m
humfrey	m
humfrid	m
humfried	m
humphrey	m
hunfredo	m
hunt	m
hunter	m
huntington	m
huntlee	m
huntley	m
huppert	m
hupprecht	m
hurlee	m
hurleigh	m
hurley	m
husain	m
husein	m
hussein	m
huyana	w
hy	m
hyacinth	b
hyacintha	w
hyacinthe	w
hyacinthia	w
hyacinthie	w
hyam	m
hyatt	m
hyazinth	m
hyazintha	w
hyder	m
hydra	w
hygin	m
hyginus	m
hylda	w
hyman	m
hymie	m
hynda	w
hynek	m
hypatia	w
hyram	m
hélène	w
hülya	w
hüseyin	m
iacchus	m
iadviga	w
iagan	m
iago	m
iain	m
iakopa	m
iakova	w
iakovleva	w
iakovlevskaia	w
iakovo	m
iakun	w
iakunova	w
iakunovaia	w
ian	m
ianevaia	w
ianisha	w
ianishe	w
ianka	w
iantha	w
ianthe	w
ianthina	w
ianto	m
iarche	w
iarena	w
iarina	w
iarlaith	m
iarogned	w
iaroia	w
iarokhna	w
iaroslava	w
iarshek	w
iason	m
iasynia	w
ibbie	w
ibby	w
ibolya	w
ibraheem	m
ibrahim	m
ichabod	m
ichiro	m
ida	w
ida-marie	w
idalia	w
idalina	w
idaline	w
idan	m
idefix	m
ideh	w
idell	w
idelle	w
idesta	w
idetta	w
idette	w
idola	w
idonea	w
idonia	w
idony	w
idoya	w
idra	w
idris	b
iduna	w
idwal	m
iefan	m
iekika	w
ieliaia	w
iesha	w
iestyn	m
iev	w
ievlia	w
ifan	m
iffi	w
ifi	w
ifigenia	w
ifigénia	w
ifrosenia	w
igan	m
igasho	m
iggie	m
iggy	m
ignaas	m
ignace	m
ignacio	m
ignacius	m
ignacy	m
ignateva	w
ignatevskaia	w
ignatia	w
ignatius	m
ignatz	m
ignaz	m
ignazio	m
igon	m
igone	w
igor	m
igoryok	m
igoshkova	w
iia	w
iida	w
iina	w
ikaia	m
ikarus	m
ike	m
ikey	m
ila	w
ilaire	m
ilan	m
ilana	w
ilar	m
ilaria	w
ilariia	w
ilario	m
ilayda	w
ilbert	m
ildi	w
ildiko	w
ildikó	w
ilean	w
ileana	w
ileane	w
ileen	w
ilene	w
ilhami	m
ilhan	m
ilia	b
ilian	m
iliana	w
iliane	w
ilias	m
ilie	m
ilija	m
ilina	w
ilinca	w
ilion	m
ilise	w
ilithya	w
iliya	m
ilja	m
iljana	w
ilka	w
ilkay	m
ilke	w
ilker	m
illa	w
illarion	m
illtyd	m
ilma	w
ilmar	m
ilmari	m
ilona	w
ilonka	w
ilpo	m
ilsa	w
ilse	w
ilta	w
iluska	w
ilva	w
ilvari	m
ilya	b
ilyas	m
ilysa	w
ilyse	w
ilyssa	w
iléktra	w
ilías	m
ima	w
imaculada	w
imad	m
imagina	w
imani	w
imanol	m
imelda	w
imelde	w
imeyna	w
imhotep	m
imilke	w
imke	w
imma	w
immacolata	w
immaculata	w
immanuel	m
immo	m
imogen	w
imogene	w
imojean	w
impi	w
imran	m
imre	m
imrus	m
ina	w
inacio	m
inanna	w
inares	w
inas	w
inbal	w
inderpal	m
india	w
indiana	w
indigo	b
indira	w
indra	w
indrani	w
indy	w
ines	w
inesita	w
inessa	w
inez	w
ing	m
inga	w
ingaberg	w
ingaborg	w
ingalf	m
ingalisa	w
ingamar	m
ingar	m
ingbert	m
inge	w
ingeberg	w
ingeborg	w
ingeburg	w
ingelbert	m
ingelore	w
ingemar	m
inger	b
ingetraud	w
ingetraut	w
inglebert	m
inglis	m
ingmar	m
ingo	m
ingobert	m
ingolf	m
ingra	m
ingram	m
ingrid	w
ingried	w
ingrim	m
ingrimon	m
ingunna	w
ingvar	m
ingve	m
ingvild	w
inigo	m
inka	w
inke	w
inken	w
inkena	w
inkeri	w
inmaculada	w
inna	w
innes	b
inness	m
innis	m
innocenco	m
innocent	m
innokenti	m
innozentia	w
innozenz	m
insa	w
into	m
inès	w
inés	w
inéz	w
inês	w
io	w
ioakim	m
ioakím	m
ioan	m
ioana	w
ioann	m
ioanna	w
ioannes	m
ioannis	m
iokua	m
iola	w
iolana	w
iolanda	w
iolande	w
iolandi	w
iolanthe	w
iole	w
iolo	m
iolyn	m
iomhar	m
ion	m
iona	w
ionatán	m
ionel	m
ionela	w
ionut	m
iordan	m
iordánis	m
iorgo	m
iorgos	m
iormina	w
iorwerth	m
iosep	m
iosif	m
iosifova	w
iov	m
iovilla	w
ioánna	w
ioánnis	m
ipati	m
iphigenie	w
iphigenie/iphigenia	w
ippokrátis	m
ippolit	m
ippolito	m
ira	b
iraida	w
iraima	w
iraklis	m
ireen	w
ireland	w
irella	w
irem	w
irema	w
irena	w
irene	w
ireneo	m
ireneus	m
ireni	w
irenka	w
irenäus	m
ireta	w
irfan	m
irial	m
irida	w
iride	w
irina	w
irinai	m
iring	m
irinia	w
irinka	w
irinushka	w
irion	m
iris	w
irisa	w
irissa	w
irit	w
irita	w
irja	w
irka	w
irma	w
irmak	w
irmela	w
irmengard	w
irmgard	w
irmhild	w
irmhilde	w
irmi	w
irmingard	w
irmtraud	w
irmtraut	w
irmtrud	w
irmuska	w
irodia	w
irodiia	w
irodotos	m
irune	w
irv	m
irvin	m
irvine	m
irving	m
irwin	m
irwinn	m
iryna	w
irène	w
iríni	w
iró	w
isa	b
isaac	m
isaak	m
isabeau	w
isabel	w
isabelita	w
isabell	w
isabella	w
isabelle	w
isac	m
isacco	m
isador	m
isadora	w
isadore	m
isafir	w
isahella	w
isai	m
isaia	m
isaiah	m
isaias	m
isak	m
isakova	w
isaline	w
isandro	m
isas	m
isaura	w
isay	m
isbel	w
iseabail	w
iseabal	w
isebella	w
iser	m
isgard	w
isha	w
ishak	m
ishbel	w
ishi	w
ishmael	m
ishmerai	m
ishtar	w
isiah	m
isiahi	m
isidor	m
isidora	w
isidore	b
isidoro	m
isidro	m
isik	m
isis	w
iska	w
iskender	m
isla	w
islav	m
islay	m
isleen	w
isleta	w
islwyn	m
ismael	m
ismagrad	w
ismail	m
ismena	w
ismene	w
ismet	m
ismini	w
ismo	m
ismíni	w
isobel	w
isocrates	m
isolda	w
isolde	w
isotta	w
isra	w
israel	m
issa	m
issac	m
issachar	m
issak	m
issi	w
issiah	m
issie	w
issur	m
issy	b
istas	w
istvan	m
ita	w
itala	w
italo	m
italus	m
itamar	m
itch	m
ithai	m
ithamar	m
ithel	m
ithiel	m
itimad	m
itka	w
itzak	m
itzal	m
itzel	w
itzhak	m
iudita	w
iulia	w
iulian	m
iuliana	w
iuliania	w
iulianiia	w
iuliia	w
iulita	w
iulitta	w
iuniia	w
iurevna	w
iustina	w
iva	w
ivah	w
ivailo	m
ivaldo	m
ivan	m
ivana	w
ivanka	w
ivanna	w
ivano	m
ivanova	w
ivanovskaia	w
ivar	m
ivaylo	m
ive	m
iven	m
iver	m
ivera	w
ives	m
iveska	w
ivett	w
ivette	w
ivie	w
ivo	m
ivonette	w
ivonne	w
ivor	m
ivory	w
ivy	w
iwan	m
iwana	w
iwanka	w
iwar	m
iwo	m
iwona	w
iyana	w
iyanna	w
iye	m
iyov	m
izaak	m
izabel	w
izabella	w
izaiah	m
izak	m
izanami	w
iziaslava	w
izidor	m
izmaragd	w
izolda	w
izumi	w
izusa	w
izzy	b
iáson	m
jaakko	m
jaana	w
jaasau	m
jabari	m
jabez	m
jabin	m
jace	m
jacek	m
jacenta	w
jacey	w
jachin	m
jacinda	w
jacinta	w
jacintha	w
jacinthe	w
jacinto	m
jack	m
jackeline	w
jackelyn	w
jacki	w
jackie	b
jacklin	w
jacklyn	w
jackquelin	w
jackqueline	w
jackson	m
jacky	b
jaclin	w
jaclyn	w
jacob	m
jacobo	m
jacoby	m
jacquelin	w
jacqueline	w
jacquelyn	w
jacquelynn	w
jacquenetta	w
jacquenette	w
jacques	m
jacquetta	w
jacquette	w
jacqui	w
jacquie	w
jacy	m
jacynth	w
jada	b
jade	w
jaden	b
jadon	m
jadwiga	w
jadyn	b
jae	m
jaeden	m
jael	w
jaelyn	w
jafar	m
jagger	m
jahaim	m
jaheem	m
jahi	m
jahiem	m
jahleel	m
jahzeel	m
jaida	w
jaiden	m
jaidyn	w
jailyn	w
jaime	b
jaimica	w
jaimie	b
jaine	w
jair	m
jairo	m
jairus	m
jakayla	w
jake	m
jakie	m
jakinda	w
jakob	m
jakobine	w
jakopo	m
jakub	m
jal	m
jala	w
jale	w
jalen	m
jaliyah	w
jalmari	m
jalynn	w
jama	w
jamaal	m
jamal	m
jamani	m
jamar	m
jamari	m
jamel	m
james	m
jameson	m
jamesy	m
jamey	m
jami	w
jamie	b
jamike	w
jamil	m
jamilah	w
jamill	m
jamima	w
jamin	m
jamir	m
jamison	m
jammal	m
jammie	w
jamya	w
jan	m
jan-hendrik	m
jan-jasper	m
jan-marco	m
jan-ole	m
jan-peter	m
jan-philipp	m
jana	w
janae	w
janaya	w
janaye	w
jandy	w
jane	w
janean	w
janeczka	w
janeen	w
janek	m
janel	w
janela	w
janella	w
janelle	w
janene	w
janenna	w
janessa	w
janet	w
janeta	w
janett	w
janetta	w
janette	w
janeva	w
janey	w
jania	w
janic	m
janice	w
janick	m
janie	w
janifer	w
janik	m
janika	w
janin	w
janina	w
janine	w
janis	b
janith	w
janiya	w
janka	w
janko	m
jann	m
janna	w
janne	b
jannek	m
jannel	w
jannelle	w
jannes	m
jannic	m
jannick	m
jannik	m
jannika	w
jannine	w
jannis	m
janny	w
jano	m
janos	m
janosch	m
janot	w
janset	w
januarius	m
janus	m
janusz	m
jany	w
japheth	m
jaquan	m
jaquelin	w
jaqueline	w
jaquelyn	w
jaquenetta	w
jaquenette	w
jaquez	m
jaquith	w
jara	w
jarad	m
jard	m
jardena	w
jareb	m
jared	m
jarek	m
jaren	m
jarena	w
jarene	w
jargo	m
jari	m
jarib	m
jarid	m
jaris	m
jarka	m
jarkko	m
jarl	m
jarlak	m
jarlath	m
jarman	m
jarmila	w
jarmo	m
jarne	m
jarno	m
jarod	m
jarohna	w
jaromir	m
jaron	m
jaroslav	m
jaroslaw	m
jarrad	m
jarred	m
jarret	m
jarrett	m
jarrid	m
jarrod	m
jarves	m
jarvia	w
jarvinia	w
jarvis	m
jascha	m
jase	m
jasen	m
jasha	m
jaska	m
jasko	m
jasmin	w
jasmina	w
jasmine	w
jasmyn	w
jasmyne	w
jasna	w
jason	m
jaspal	m
jasper	m
jasun	m
javan	m
javen	m
javier	m
javion	m
javon	m
jaxine	w
jaxon	m
jay	m
jaya	w
jayce	m
jaycee	w
jayda	w
jayde	w
jayden	b
jaydon	m
jaye	m
jayla	w
jaylan	m
jaylen	m
jaylene	w
jaylin	b
jaylynn	w
jayme	b
jaymee	w
jaymie	m
jayne	w
jaynell	w
jayson	m
jazlyn	w
jazmin	w
jazmyn	w
jazzy	w
jdavie	m
jean	b
jean-claude	m
jeana	w
jeane	w
jeanelle	w
jeanette	w
jeanie	w
jeanine	w
jeanna	w
jeanne	w
jeannette	w
jeannie	w
jeannine	w
jecho	m
jed	m
jedd	m
jeddy	m
jedediah	m
jedidah	w
jedidiah	m
jeff	m
jefferey	m
jefferson	m
jeffie	m
jeffrey	m
jeffry	m
jeffy	m
jehanna	w
jehanne	w
jehiel	m
jehoash	m
jehoiachin	m
jehoiakim	m
jehoshaphat	m
jehu	m
jeirgif	m
jekaterina	w
jeldrik	m
jelena	w
jelene	w
jelenka	w
jelica	w
jelizaveta	w
jelka	w
jella	w
jelle	m
jemie	w
jemima	w
jemimah	w
jemma	w
jemmie	w
jemmy	w
jen	w
jena	w
jenay	w
jenda	w
jendrik	m
jenelle	w
jeni	w
jenica	w
jeniece	w
jenifer	w
jeniffer	w
jenilee	w
jenine	w
jenn	w
jenna	w
jennee	w
jennette	w
jenni	w
jennica	w
jennie	w
jennifer	w
jennilee	w
jennine	w
jenny	w
jeno	m
jens	m
jens-peter	m
jens-uwe	m
jensine	w
jephtha	m
jephthah	m
jeppe	m
jera	w
jerad	m
jerald	m
jeralee	w
jeramey	m
jeramie	m
jere	b
jereme	m
jeremiah	m
jeremias	m
jeremie	m
jeremiel	m
jeremy	m
jergan	m
jerges	m
jeri	w
jeriah	m
jericho	m
jerk	m
jermain	m
jermaine	b
jermayne	m
jermija	m
jerolin	m
jerome	m
jeromy	m
jeronima	w
jeronimus	m
jerri	m
jerrie	b
jerrilee	w
jerrilyn	w
jerrine	w
jerrold	m
jerrome	m
jerry	b
jerrylee	w
jerusha	w
jervis	m
jerzy	m
jesajas	m
jesko	m
jesper	m
jess	b
jessa	w
jessalin	w
jessalyn	w
jessamine	w
jessamyn	w
jesse	b
jessee	m
jesselyn	w
jessey	m
jessi	w
jessica	w
jessie	b
jessika	w
jessy	w
jesus	m
jeth	m
jethro	m
jett	m
jette	w
jevdokija	w
jevon	m
jewel	w
jewell	w
jewelle	w
jezabel	w
jezebel	w
jil	w
jill	w
jillana	w
jillane	w
jillayne	w
jilleen	w
jillene	w
jilli	w
jillian	w
jillie	w
jilly	w
jim	m
jimena	w
jimi	m
jimmie	m
jimmy	m
jina	w
jindra	w
jinny	w
jinx	w
jiri	m
jitka	w
jivin	m
jo	b
jo-ann	w
jo-anne	w
joab	m
joachim	m
joakim	m
joakima	w
joan	b
joana	w
joane	w
joanie	w
joann	w
jo ann	w
joanna	w
joanne	w
joannes	w
joaquin	m
joash	m
job	m
jobey	w
jobi	w
jobie	w
jobihna	w
jobina	w
jobst	m
joby	w
jobye	w
jobyna	w
jocasa	w
jocelin	w
joceline	w
jocelyn	w
jocelyne	w
jochebed	w
jochem	m
jochen	m
jock	m
jocko	m
jodee	w
jodene	w
jodi	b
jodie	b
jodokus	m
jody	b
joe	m
joeann	w
joel	m
joel-cassian	m
joela	w
joelie	w
joelina	w
joeline	w
joell	w
joella	w
joelle	w
joellen	w
joelliane	w
joelly	w
joellyn	w
joelynn	w
joerg	m
joete	w
joey	b
johan	m
johann	m
johanna	w
johannah	w
johanne	w
johannes	m
john	m
johna	w
johnath	w
johnathan	m
johnathon	m
johnette	w
johnna	w
johnnie	m
johnny	m
johny	m
joia	w
joice	w
jojo	w
jokim	m
jolanda	w
jolanta	w
jolantha	w
jolanthe	w
jolee	w
joleen	w
jolene	w
joletta	w
joli	w
jolie	w
jolien	w
jolina	w
joline	w
jolon	m
joly	w
jolyn	w
jolynn	w
jon	m
jona	b
jonah	b
jonas	m
jonas-elias	m
jonatan	m
jonathan	m
jonathon	m
jone	m
jonell	w
jonetta	w
joni	b
jonie	w
jonina	w
jonis	w
jonna	w
jonne	m
jonte	m
joona	m
joonas	m
joost	m
jora	w
jordain	w
jordan	b
jordana	w
jordane	w
jordanna	w
jorden	m
jordon	m
jordy	m
jordyn	w
jorey	w
jorgan	m
jorge	m
jorgen	m
jori	w
jorid	w
jorie	w
joris	m
jorja	w
jorma	m
jorrie	w
jorry	w
jory	m
joscelin	w
josceline	w
joscha	m
joschka	m
joschua	m
jose	m
josee	w
josef	m
josefa	w
josefiina	w
josefin	w
josefina	w
josefine	w
josefita	w
joseito	m
joseline	w
joselyn	w
joseph	m
josepha	w
josephin	w
josephina	w
josephine	w
josephine/ josefine	w
joses	m
josette	w
josey	w
josh	m
joshia	m
joshua	m
joshuah	m
josi	w
josiah	m
josias	m
josie	w
josina	w
josip	m
joslyn	w
josold	m
josse	m
josselyn	w
jost	m
josua	m
josy	w
josé	m
josée	w
joséphine	w
jotham	m
jouko	m
jourdain	m
jourdan	w
journey	w
jov	m
jovan	m
jovani	m
jovanka	w
jovany	m
jove	m
jovita	w
joy	w
joya	w
joyan	w
joyann	w
joyce	w
joycelin	w
joye	w
joyous	w
jozef	m
jozette	w
joël	m
joëlle	w
jsandye	w
juan	m
juana	w
juanita	w
juan manuel	m
jubal	m
juban	m
jud	m
judah	m
judas	m
judd	m
jude	b
judi	w
judie	w
judita	w
judith	w
juditha	w
judon	m
judy	w
judye	w
juergen	m
juha	m
juhani	m
juho	m
juieta	w
jukka	m
jukundus	m
jule	b
julee	w
jules	m
juli	w
julia	w
julian	m
juliana	w
juliane	w
juliann	w
julianna	w
julianne	w
julie	b
julien	m
julienne	w
juliet	w
julieta	w
julietta	w
juliette	w
julika	w
julina	w
juline	w
julinka	w
julio	m
julissa	w
julita	w
juliun	m
julius	m
jumah	m
juna	w
june	w
junette	w
junia	w
junie	w
junina	w
junior	m
junius	m
jurek	m
jurg	m
juri	m
jurica	m
jurij	m
jusilia	w
jussi	m
jussuf	m
justen	m
justin	m
justina	w
justine	w
justinian	m
justinn	w
justino	m
justis	m
justus	m
justyn	m
justyna	w
jutta	w
jutte	w
juturna	w
juuso	m
juán	m
jyoti	w
jyrki	m
jytte	w
jérémie	m
jérôme	m
jöns	m
jöran	m
jördis	w
jörg	m
jörg-peter	m
jörgen	m
jörn	m
jörna	w
jülide	w
jürg	m
jürgen	m
kaan	m
kaapo	m
kaarlo	m
kaarpo	m
kaatje	w
kabos	m
kace	w
kacey	w
kacha	w
kache	w
kachina	w
kachka	w
kacie	w
kacy	w
kade	m
kaden	m
kader	w
kadin	m
kadir	m
kadisha	w
kaela	w
kaethe	w
kaga	m
kagami	w
kagan	m
kahaleel	m
kahlil	m
kai	b
kai-uwe	m
kaia	w
kaija	w
kaila	w
kaile	w
kailey	w
kain	m
kaine	m
kaisa	w
kaiser	m
kaitlin	w
kaitlyn	w
kaitlynn	w
kaito	m
kaiya	w
kaj	m
kaja	w
kajetan	m
kajsa	w
kakalina	w
kala	w
kalama	w
kalanit	w
kalashatra	w
kale	m
kalea	w
kaleb	m
kaleena	w
kaleigh	w
kaleo	m
kaleria	w
kaleriia	w
kalervo	m
kalev	m
kaleva	m
kalevi	m
kali	w
kalia	w
kalidas	m
kalie	w
kalika	w
kalil	m
kalila	w
kalina	w
kalinda	w
kalindi	w
kalinka	w
kalisa	w
kalisfena	w
kaliska	w
kalista	w
kalitina	w
kaliya	w
kalkin	m
kalle	m
kalli	w
kallias	m
kallie	w
kallikrates	m
kalliope	w
kallisfeniia	w
kallista	w
kallisto	m
kallistus	m
kalliópi	w
kally	w
kalman	m
kalomíra	w
kalonice	w
kalotína	w
kaloyan	m
kalvin	m
kalyan	m
kalyca	w
kalyn	w
kam	m
kama	w
kamal	m
kamala	w
kamaria	w
kamata	w
kamber	m
kameke	w
kameko	w
kamenka	w
kameron	m
kami	w
kamil	m
kamila	w
kamilah	w
kamilia	w
kamilla	w
kamillah	w
kamle	w
kamron	m
kamryn	w
kandace	w
kandaza	w
kandy	w
kane	m
kania	w
kaniel	m
kanika	w
kantha	w
kanya	w
kaolin	m
kapel	m
kapetolina	w
kapil	m
kaptelina	w
kapua	w
kara	w
kara-lynn	w
karalee	w
karalynn	w
karam	m
karamba	m
karan	m
kare	w
karee	w
kareem	m
karel	b
karella	w
karen	w
karena	w
kari	w
karia	w
karida	w
karie	w
karil	w
karilynn	w
karim	m
karima	w
karin	w
karina	w
karine	w
karinna	w
kariotta	w
karisa	w
karishma	w
karissa	w
karita	w
karl	m
karl-august	m
karl-dieter	m
karl-ernst	m
karl-friedrich	m
karl-georg	m
karl-gustav	m
karl-hans	m
karl-heinrich	m
karl-heinz	m
karl-hermann	m
karl-josef	m
karl-jürgen	m
karl-ludwig	m
karl-otto	m
karl-peter	m
karl-werner	m
karl-wilhelm	m
karla	w
karlan	m
karlee	w
karleen	w
karlen	w
karlene	w
karlens	m
karley	w
karlfried	m
karl heinz	m
karlheinz	m
karlie	w
karlik	m
karlis	m
karlo	m
karlotta	w
karlotte	w
karlsson	m
karly	w
karlyn	w
karmen	w
karna	w
karney	m
karol	b
karola	w
karole	w
karolek	m
karolin	w
karolina	w
karoline	w
karolis	m
karoly	b
karon	b
karp	m
karpova	w
karpovskaia	w
karrah	w
karrie	w
karrine	w
karry	w
karson	m
karsten	m
karuna	w
kary	w
karyl	w
karylin	w
karyn	w
karyna	w
kasey	b
kasha	w
kashka	w
kasia	w
kasilda	w
kasimir	m
kasinda	w
kaspar	m
kasper	m
kasperi	m
kass	w
kassandra	w
kassey	w
kassi	w
kassia	w
kassidy	w
kassie	w
kassiopeia	w
kassius	m
kassándra	w
kastor	m
kat	w
kata	w
kataldo	m
katalena	w
katalin	w
katalyn	w
katareena	w
katarina	w
katarzyna	w
kate	w
katee	w
kateena	w
katelynn	w
katerina	w
katerine	w
katerinió	w
katerinka	w
katerína	w
katey	w
kath	w
katha	w
katharina	w
katharine	w
katharyn	w
kathe	w
katherina	w
katherine	w
katheryn	w
kathi	w
kathie	w
kathleen	w
kathlin	w
kathrin	w
kathrina	w
kathrine	w
kathryn	w
kathryne	w
kathy	w
kathye	w
kati	w
katia	w
katie	w
katina	w
katine	w
katinió	w
katinka	w
katiya	w
katja	w
katjuscha	w
katleen	w
katlin	w
katlina	w
katreen	w
katreena	w
katrein	w
katrene	w
katria	w
katrien	w
katrin	w
katrina	w
katrine	w
katrinka	w
katrusha	w
katrya	w
katryn	w
katryna	w
katti	w
kattie	w
kattrina	w
kattryna	w
katunia	w
katuscha	w
katusha	w
katy	w
katya	w
katyenka	w
katyushka	w
katyuska	w
katía	w
katíga	w
katína	w
kauko	m
kaula	w
kauno	m
kavindra	w
kavita	w
kay	b
kay-uwe	m
kaya	w
kaycee	w
kayden	m
kaye	w
kayetan	m
kayin	m
kayla	w
kaylah	w
kayle	w
kaylee	w
kayleigh	w
kayley	w
kaylil	w
kaylin	w
kaylyn	w
kaylynn	w
kayne	m
kayra	w
kaysa	w
kazdoia	w
kazia	w
kazim	m
kazimir	m
kazuki	m
keagan	m
kealan	m
kean	m
keane	m
keanu	m
keara	w
kearney	m
keary	m
keaton	m
keavy	w
keefe	m
keefer	m
keegan	m
keelan	m
keelby	m
keeley	w
keelia	w
keelin	w
keely	w
keen	m
keenan	m
keene	m
kees	m
kefira	w
kegan	m
keila	w
keir	m
keira	w
keisha	w
keith	m
kekona	w
kelan	m
kelbee	m
kelby	m
kelcey	b
kelci	w
kelcie	w
kelcy	w
keld	m
kelda	w
kele	b
kelemen	m
kelila	w
kell	m
kellby	m
kellen	b
kelley	b
kelli	w
kellia	w
kellie	w
kellina	w
kellsie	w
kelly	b
kellyann	w
kelsey	b
kelsi	w
kelsie	w
kelsy	w
kelton	m
kelvin	m
kelwin	m
kemal	m
ken	m
kenan	m
kenaniah	m
kendal	m
kendall	b
kendell	m
kendra	w
kendre	w
kendrick	m
kendricks	m
kenelm	m
kenia	w
kenith	m
kenley	m
kenn	m
kenna	w
kennan	m
kennard	m
kennedy	m
kennet	m
kenneth	m
kennett	m
kennie	m
kennith	m
kenny	m
keno	m
kenon	m
kenrick	m
kent	m
kentigern	m
kenton	m
kenya	w
kenyon	m
kenzie	b
kenzo	m
keon	m
keoni	m
kephas	m
ker	m
keran	m
kerby	m
kerel	m
kerem	m
keri	w
keriann	w
kerianne	w
kerim	m
kerk	m
kerkira	w
kerkko	m
kerman	m
kermie	m
kermit	m
kermy	m
kerneels	m
kerr	m
kerri	w
kerrie	w
kerrill	w
kerrin	w
kerry	b
kersten	w
kerstin	w
kerwin	m
kerwinn	m
keshaun	m
keshet	m
keshia	w
kesley	w
keslie	w
kessia	w
kessiah	w
kessie	w
kester	m
ketti	w
kettie	w
kettil	m
ketty	w
ketura	w
kev	m
kevan	m
keven	m
kevin	m
kevina	w
kevon	m
kevork	m
kevyn	w
keyla	w
keyon	m
keyshawn	m
kezban	w
keziah	w
khaleel	m
khalid	m
khalida	w
khalil	m
kharesa	w
khariessa	w
kharitaniia	w
kharitina	w
khariton	m
kharitona	w
kharitonova	w
kheoniia	w
khioniia	w
khlopyreva	w
khovra	w
khrana	w
khrisiia	w
khristeen	w
khristen	w
khristianova	w
khristin	w
khristina	w
khristine	w
khristyana	w
khristyna	w
khrstina	w
khrystina	w
khrystyn	w
khrystyne	w
khvalibud	w
khynika	w
ki	w
kiah	w
kial	w
kian	m
kiana	w
kiara	w
kiaran	m
kibbe	m
kiel	m
kiele	w
kienan	m
kiera	w
kieran	m
kieron	m
kierra	w
kiersten	w
kiia	w
kikelia	w
kiki	w
kikiliia	w
kiku	w
kile	m
kiley	b
kilian	m
kilikeia	w
kilikiia	w
killian	m
killie	m
killy	m
kim	b
kimama	w
kimball	m
kimbell	m
kimberlee	w
kimberley	w
kimberli	w
kimberly	w
kimberlyn	w
kimble	m
kimbra	w
kimi	b
kimmi	w
kimmie	w
kimmon	m
kimmy	w
kimo	m
kin	m
kincaid	m
kineta	w
king	m
kinga	w
king kong	m
kingsley	m
kingsly	m
kingston	m
kinna	w
kinnel	m
kinnie	m
kinny	m
kinsey	m
kinsley	m
kiona	w
kip	b
kipling	m
kipp	b
kippar	m
kipper	m
kippie	b
kippy	b
kiprilla	w
kira	w
kiraanna	w
kirabo	m
kiran	m
kirana	w
kirbee	w
kirbie	w
kirby	b
kiri	w
kiriakiia	w
kiriakos	m
kiriena	w
kiril	m
kirill	m
kirilla	w
kirilovskaia	w
kirim	m
kirima	w
kirk	m
kirke	w
kirkwood	m
kirsi	w
kirsten	b
kirsteni	w
kirsti	w
kirstin	w
kirsty	w
kirstyn	w
kisa	w
kishan	m
kishi	w
kiska	w
kismet	w
kissa	w
kissee	w
kissiah	w
kissie	w
kistna	m
kit	b
kito	m
kitsa	w
kitti	w
kittiana	w
kittie	w
kitty	w
kiuprila	w
kiuriakiia	w
kiwa	w
kiya	w
kiyoshi	m
kiza	w
kizza	m
kizzee	w
kizzie	w
kjeld	m
kjell	b
kjetil	m
klaas	m
klara	w
klarika	w
klarissa	w
klarrisa	w
klasha	w
klaudia	w
klaudius	m
klaus	m
klaus-dieter	m
klaus-günter	m
klaus-jürgen	m
klaus-michael	m
klaus-peter	m
klaus-ulrich	m
klaus-werner	m
klaus dieter	m
klaus peter	m
klavdiia	w
klea	w
kleanthis	m
kleitos	m
klemens	m
klement	m
klementine	w
klemenz	m
kleon	m
kleopas	m
kleopatra	w
kleopha	w
kleopátra	w
klevi	w
kleó	w
kliment	m
klothilde	w
klotild	w
klotilde	w
klychikha	w
kläre	w
knikki	w
knorrholde	w
knox	m
knud	m
knut	m
kobus	m
koby	m
kodey	m
kody	m
koen	m
koenraad	m
koenrad	m
kogorshed	w
koia	w
koika	w
kojo	m
koko	w
kolby	m
koldo	m
koldobika	m
kole	m
kolina	w
kolja	m
kolman	m
koloman	m
kolomianka	w
kolumbus	m
kolya	m
kona	w
konchaka	w
konchasha	w
kondrat	m
konkordiia	w
konnor	m
kono	m
konrad	m
konradin	m
konsta	m
konstance	w
konstandínos	m
konstantiia	w
konstantin	m
konstantina	w
konstantine	b
konstantinos	m
konstantyn	m
konstantína	w
konstanze	w
konstiantina	w
konstiantinova	w
koo	w
koos	m
koppel	m
kora	w
koral	w
koraldo	m
koralle	w
koray	m
korbin	m
korbinian	m
kord	m
kordula	w
kore	w
korella	w
koren	w
koressa	w
koretskaia	w
korey	m
kori	w
korie	w
korina	w
korinna	w
korinne	w
korna	w
korneel	m
kornel	m
kornelia	w
kornelio	m
kornelius	m
korney	w
korotkaia	w
korotkova	w
korotsek	w
korotskovaia	w
korrie	w
korry	w
kort	m
korudon	m
kory	m
kosa	w
kosenila	w
kosmas	m
kosmás	m
kosta	m
kostandin	m
kostenka	w
kostja	m
kostya	b
kostyusha	w
kostís	m
kotik	w
kourtney	b
kovan	w
kovana	w
kowan	w
kozma	b
kozmina	w
krabava	w
krasa	w
krasimir	m
krastio	m
kreon	m
kresimir	m
kreso	m
kresten	m
krestiia	w
kreszentia	w
kreszenz	w
kriemhild	w
krikor	m
krimhild	w
kris	b
krischan	m
krisha	m
krishna	m
krishnah	m
krishnan	m
krispin	m
kriss	m
krissie	w
krissy	w
krista	w
kristal	w
kristan	w
kristaps	m
kriste	w
kristel	w
kristen	b
krister	m
kristi	w
kristian	m
kristiana	w
kristiane	w
kristien	w
kristijan	m
kristin	w
kristina	w
kristine	w
kristjan	m
kristo	m
kristof	m
kristofer	m
kristoffer	m
kristofor	m
kristoforo	m
kristopher	m
kristos	m
kristy	w
kristyn	w
krivulinaia	w
kronos	m
krunevichovna	w
krushka	w
krysta	w
krystal	w
krystalena	w
krystalle	w
krystian	m
krystle	w
krystof	m
kryston	m
krystyna	w
krzysztof	m
ksafipa	w
ksana	w
ksanfippa	w
ksanochka	w
ksawery	m
ksenia	w
kseniia	w
kseniya	w
ksenya	w
kshtovtovna	w
ksnia	w
ksniatintsa	w
kuba	m
kudra	w
kula	w
kulman	m
kuma	w
kumar	m
kumi	b
kuna	w
kunal	m
kunei	w
kuni	w
kunibert	m
kunigunda	w
kunigunde	w
kunka	w
kunko	w
kunku	w
kuno	m
kuntse	w
kunz	m
kuri	w
kuriana	w
kuro	m
kurt	m
kurtis	m
kusmara	w
kusmina	w
kustaa	m
kusti	m
kuzey	m
kuzma	m
kuznetsova	w
kvasena	w
kvetava	w
kwabina	w
kwako	b
kwamin	m
kwashi	w
kwesi	m
ky	m
kya	w
kyla	w
kylan	m
kyle	b
kylee	w
kyleigh	w
kylen	w
kyler	m
kylian	m
kylie	b
kylila	w
kylynn	w
kym	w
kyna	w
kynaston	m
kyne	m
kynthia	w
kyo	m
kyoko	w
kyra	w
kyran	m
kyree	m
kyriakos	m
kyriakí	w
kyriákos	m
kyros	m
kyrstin	w
kyrylo	m
kysira	w
kyösti	m
kzhna	w
káchis	m
kákis	m
károlos	m
kássandros	m
käte	w
käthe	w
käthe-amalia	w
käthi	w
kímon	m
kóstas	m
l	w
laban	m
lacee	w
lacey	b
lachina	w
lachlan	m
laci	m
lacie	w
lacy	w
lada	w
ladek	m
ladislao	m
ladislas	m
ladislaus	m
lado	m
ladonna	w
lael	m
laelia	w
laertes	m
laetitia	w
lagina	w
lahja	w
laika	w
laikina	w
laila	w
lailie	w
laima	w
laina	w
lainey	w
laird	m
laja	w
lajos	m
lake	m
lakeisha	w
lakeshia	w
lakisha	w
lala	w
lale	w
lalia	w
lalita	w
lalla	w
lallie	w
lally	w
lalo	m
lamar	m
lambert	m
lamberta	w
lambertine	w
lamberto	m
lambrecht	m
lamea	w
lamech	m
lammert	m
lammond	m
lamond	m
lamont	m
lampert	m
lamprecht	m
lamya	w
lana	w
lanae	w
lanassa	w
lanata	w
lance	m
lancelot	m
land	m
lander	m
landers	m
landoald	m
landolf	m
landon	m
landor	m
lane	b
lanette	w
laney	b
lanford	m
langdon	m
langsdon	m
langston	m
langundo	m
lani	w
lanie	b
lanita	w
lanka	w
lanna	w
lanni	w
lannie	m
lanny	b
lanty	m
lanzo	m
laodamia	w
laoghaire	m
laoise	w
laokoon	m
lara	w
laraine	w
lares	m
lareyna	w
lari	w
laria	w
larina	w
larine	w
larisa	w
larissa	w
larissos	m
lark	w
larkin	m
larochka	w
larra	w
larrie	m
larry	m
lars	m
larsina	w
laryn	w
laryssa	w
lashay	m
lashonda	w
laslo	m
lassarina	w
lasse	m
lasse-sixten	m
lassi	m
laszlo	m
lata	w
latanya	w
latasha	w
latashia	w
latia	w
latif	m
latika	w
latisha	w
latona	w
latonia	w
latonya	w
latoya	w
latrell	m
latrena	w
latrina	w
latskaia	w
lauchlan	m
laughlin	m
laughton	m
launce	m
launo	m
laura	w
lauraine	w
laural	w
lauralee	w
laurane	w
lauranne	w
laure	w
lauree	w
laureen	w
laurel	w
laurella	w
laurelle	w
lauren	b
laurena	w
laurence	b
laurencia	w
laurene	w
laurens	m
laurent	m
laurente	m
laurentia	w
laurentine	w
laurentius	m
laurenz	m
lauressa	w
lauretta	w
laurette	w
lauri	b
lauriane	w
laurianne	w
laurice	w
laurie	b
laurin	m
laurina	w
laurinda	w
laurine	w
laurissa	w
laurita	w
laurits	m
lauritz	m
lauro	m
lauryn	w
lavanya	w
laveda	w
lavena	w
lavender	w
lavern	m
laverna	w
la verne	w
laverne	w
lavi	m
lavina	w
lavinia	w
lavinie	w
lavone	w
lavonne	w
lavra	w
lavrans	m
lavrenti	m
lavrentios	m
lavrenty	m
law	m
lawanda	w
lawler	m
lawrence	m
lawrie	m
lawry	m
lawson	m
lawton	m
laxman	m
lay	m
layla	w
laylin	w
layna	w
layne	b
layney	w
layton	m
laz	m
laza	m
lazar	m
lazare	m
lazaro	m
lazarus	m
lazer	m
lazi	m
lazzaro	m
laçin	m
lea	w
lea-sophie	w
leachlainn	m
leah	w
leala	w
lean	m
leana	w
leander	m
leandra	b
leandro	m
leandros	m
leann	w
leanna	w
leanne	w
leanor	w
leanora	w
lear	m
learco	m
leart	m
leatrice	w
leba	w
lebbie	w
leberecht	m
lech	m
lechdan	m
lecia	w
leda	w
ledah	w
lee	b
leeann	w
leeanne	w
leeba	w
leela	w
leelah	w
leeland	m
leena	w
leesa	w
leese	w
leevi	m
lefteris	m
lefty	m
leftéris	m
legolas	m
legra	w
lehi	m
leia	w
leicester	m
leif	m
leigh	b
leigha	w
leighton	m
leila	w
leilah	w
leilana	w
leilani	w
leisa	w
leisha	w
leith	m
lejla	w
lek	m
leka	w
lela	w
lelah	w
leland	b
lelia	w
lelik	w
lem	m
lemar	m
lemmie	m
lemmikki	w
lemmy	m
lemoine	m
lemuel	m
lemuela	w
len	m
lena	w
lenard	m
lenardo	m
lenci	m
lency	w
lene	w
lenee	w
lenette	w
leni	w
lenia	w
lenina	w
lenira	w
lenja	w
lenka	w
lenn	m
lenna	w
lennard	m
lennart	m
lenni	m
lennie	m
lenno	m
lennon	m
lennor	m
lennox	m
lenny	m
lenochka	w
lenora	w
lenore	w
lenox	m
lensar	m
lenusy	w
lenusya	w
lenuta	w
lenya	w
lenz	m
leo	m
leocadia	w
leocadio	m
leodora	w
leofric	m
leoine	w
leokadia	w
leola	w
leolin	m
leoline	w
leomar	m
leon	m
leona	w
leonanie	w
leonard	m
leonardo	m
leonas	m
leonce	m
leoncino	m
leoncio	m
leone	b
leonel	m
leonelle	w
leonerd	m
leonhard	m
leoni	w
leonid	m
leonidas	m
leonide	m
leonie	w
leonilla	w
leonius	m
leonor	w
leonora	w
leonore	w
leonteva	w
leonti	m
leontina	w
leontine	w
leontius	m
leonty	m
leontyne	w
leonzio	m
leonídas	m
leopold	m
leopoldine	w
leopoldo	m
leora	w
leos	m
leotie	w
lepa	w
lera	w
lerka	w
leroi	m
leron	m
leroy	m
les	m
leshem	m
leshia	w
lesia	w
leska	w
lesley	b
lesli	w
leslie	b
lesly	w
lessie	w
lestat	m
lester	m
lesya	w
leszek	m
leta	w
letha	w
lethia	w
leticia	w
letisha	w
letitia	w
letizia	w
letta	w
letti	w
lettice	w
lettie	w
letty	w
leupold	m
lev	m
leva	w
levana	w
levey	m
levi	m
levin	m
levka	m
levke	w
levon	m
levy	m
lew	m
lewella	w
lewes	m
lewie	m
lewin	m
lewis	m
lewiss	m
lex	m
lexa	w
lexi	w
lexia	w
lexie	w
lexine	w
lexis	w
lexy	w
leya	w
leyla	w
leyton	m
lezley	m
lezlie	w
leándra	w
lia	w
liadan	w
liah	w
liam	m
lian	b
liana	w
liane	w
lianella	w
lianna	w
lianne	w
lias	m
liat	w
lib	w
liba	w
libania	w
libbey	w
libbi	w
libbie	w
libby	w
libena	w
liberatore	m
liberia	w
liberius	m
liberty	w
libitina	w
libor	m
liboria	w
liborio	m
liborius	m
libusa	w
libussa	w
licha	w
lida	w
liddy	w
lidena	w
lidia	w
lidiia	w
lidija	w
lidiy	w
lidiya	w
lidka	w
lidmila	w
lidocha	w
lidochka	w
lidwina	w
lieba	w
lieber	m
liebfried	m
liebizo	m
lief	m
lien	m
lienhard	m
liesa	w
liesbeth	w
lieschen	w
liese	w
liesel	w
lieselotte	w
liesje	w
liesl	w
lieven	m
ligeia	w
liinu	w
liisa	w
liisu	w
lika	w
lil	w
lila	w
lilac	w
lilah	w
lilas	w
lileas	w
lili	w
lilia	w
lilian	w
liliana	w
liliane	w
lilianne	w
lilias	w
lilija	w
lilioara	w
lilith	w
lilja	w
liljana	w
lilla	w
lilli	w
lillia	w
lillian	w
lillias	w
lillie	w
lillis	w
lilllie	w
lilly	w
lillybell	w
lillyda	w
lilo	w
liluye	w
lily	w
lilyan	w
lilyana	w
limone	w
lin	b
lina	w
lina-madita	w
linaria	w
linas	m
linc	m
lincoln	m
lind	b
linda	w
linde	w
lindi	w
lindie	w
lindon	m
lindsay	b
lindsey	b
lindsie	w
lindsy	w
lindy	b
line	w
linea	w
linell	w
linet	w
linette	w
linford	m
link	m
linn	b
linnaea	w
linnart	m
linnea	w
linnell	w
linnert	m
linnet	w
linnette	w
linnie	w
linnéa	w
linnéa-valentina	w
lino	m
linoel	m
linos	m
linsay	w
linsey	w
linton	m
linus	m
linzi	w
linzy	w
lio	m
lioba	w
liolya	w
lion	m
liona	w
lionel	m
lionello	m
lior	m
liouba	w
lipa	w
lir	m
lira	w
liron	m
lis	w
lisa	w
lisa-marie	w
lisabet	w
lisabeth	w
lisandro	m
lisanka	w
lisanne	w
lisaveta	w
lisbeth	w
lise	w
liseetsa	w
liselot	w
liselotte	w
lisetta	w
lisette	w
lisha	w
lishe	w
lishka	w
lisiane	w
lisil	w
liska	w
lisle	m
lisotianka	w
lissa	w
lissi	w
lissie	w
lissy	w
lita	w
litonya	w
litsa	w
litzy	w
liuba	w
liubchanina	w
liubka	w
liubokhna	w
liubone	w
liubusha	w
liudena	w
liudmila	w
liudmyla	w
liudvikas	m
liuka	w
liunharda	w
liutarda	w
liutsilla	w
liv	w
liva	w
livana	w
livanga	w
livia	w
liviana	w
livio	m
livius	m
livna	w
livvie	w
livvy	w
livvyy	w
livy	b
liya	w
liz	w
liza	w
lizabeta	w
lizabeth	w
lizanka	w
lizaveta	w
lizbeth	w
lizeth	w
lizette	w
lizolet	w
lizzie	w
lizzy	w
ljiljana	w
ljubica	w
ljubomir	m
ljudmila	w
ljudmilla	w
llewellyn	m
lloyd	m
llywellyn	m
loarne	m
lobita	w
lochlainn	m
lochlann	m
lock	m
locke	m
lockie	m
lockwood	m
lodewik	m
lodovico	m
loella	w
loes	w
logan	b
loida	w
lois	b
loise	w
lola	w
loleta	w
lolicia	w
lolita	w
lolly	w
lolya	w
lomasi	w
lombard	m
lommán	m
lomán	m
lon	m
lona	w
lonato	m
london	m
lonee	w
longinus	m
loni	w
lonna	w
lonnard	m
lonni	w
lonnie	b
lonny	m
lonán	m
loona	w
lopez	m
lora	w
lorain	w
loraine	w
loralee	w
loralie	w
loralyn	w
lorant	m
lorayne	w
lorcán	m
lore	w
lorea	w
loredana	w
loree	w
loreen	w
lorelei	w
lorelle	w
loren	b
lorena	w
lorencio	m
lorene	w
lorens	m
lorenz	m
lorenza	w
lorenzo	m
loretta	w
lorettalorna	w
lorette	w
loretto	m
lori	w
loria	w
lorianna	w
lorianne	w
lorie	w
lorilee	w
lorilyn	w
lorin	b
lorinda	w
lorine	w
loriot	m
loris	b
lorita	w
lorn	m
lorna	w
lorne	b
lorraine	w
lorrayne	w
lorri	w
lorrie	b
lorrin	b
lorry	b
lory	w
losan	m
losiane	w
lot	m
lotha	w
lothair	m
lothaire	m
lothar	m
lothario	m
lothur	m
lotta	w
lotte	w
lotti	w
lottie	w
lotty	w
lotus	w
lou	b
louella	w
louie	b
louis	m
louisa	w
louise	w
louisette	w
louiza	w
loup	m
lourdes	w
lourenco	m
loutitia	w
lova	w
love	m
lovel	m
lovell	m
lovis	m
lovisa	w
lovise	w
lovrenc	m
lovro	m
lowe	m
lowell	m
lowrance	m
loy	m
loyd	m
loydie	m
lu	b
luan	m
luana	w
luanna	w
luanne	w
luba	w
lubachitsa	w
lubbert	m
luben	m
lubmila	w
lubmilla	w
lubna	w
lubohna	w
lubomierz	m
lubomir	m
lubov	w
lubusha	w
luc	m
luca	b
lucais	m
lucas	m
lucasta	w
luce	b
lucetta	w
lucette	w
lucho	m
luci	w
lucia	w
lucian	m
luciana	w
luciano	m
lucias	m
lucie	w
lucien	m
lucienne	w
lucifer	m
lucija	w
lucila	w
lucile	w
lucilia	w
lucilla	w
lucille	w
lucina	w
lucinda	w
lucine	w
lucio	m
lucita	w
lucius	m
lucjan	m
lucky	b
lucrece	w
lucretia	w
lucrezia	w
lucy	w
luda	w
ludde	m
ludewig	m
ludger	m
ludiia	w
ludivine	w
ludmia	w
ludmila	w
ludmilla	w
ludo	m
ludomia	w
ludovic	m
ludovica	w
ludovico	m
ludovika	w
ludoviko	m
ludvig	m
ludvik	m
ludwig	m
ludwiga	w
ludwik	m
ludwika	w
ludwina	w
luella	w
luelle	w
luigi	m
luigia	w
luigina	w
luigino	m
luis	m
luis-miguel	m
luisa	w
luise	w
luise-wilhelmine	w
luisella	w
luitgard	w
luitger	m
luitpold	m
luiz	m
lujuana	w
lujza	w
luka	b
lukas	m
luke	m
lukeria	w
lukerina	w
lukerya	w
lukiia	w
lukina	w
lukiria	w
lukoianova	w
lukretia	w
lukyan	m
lukás	m
lula	w
lulita	w
lulu	w
lumi	w
lumikki	w
luminita	w
luna	w
lunetta	w
lunt	m
lupita	w
lupo	m
lura	w
lurette	w
lurleen	w
lurlene	w
lurline	w
lusa	w
lusela	w
lutea	w
lutero	m
lutgard	w
luther	m
lutisana	w
lutricia	w
lutz	m
luuk	m
luukas	m
luvenia	w
luvinia	w
lux	w
luz	w
luzi	w
luzia	w
luzie	w
luzius	m
lvovicha	w
ly	m
lya	w
lyalechka	w
lyall	m
lyalya	w
lyane	w
lybed	w
lycurgus	m
lyda	w
lydia	w
lydie	w
lydon	m
lyell	m
lyeta	w
lykaios	b
lykaon	m
lyl	w
lyle	b
lyman	m
lyn	b
lynda	w
lynde	w
lyndel	w
lyndell	w
lynden	m
lyndi	w
lyndon	m
lyndsay	w
lyndsea	w
lyndsey	w
lyndsie	w
lyndy	w
lynea	w
lynelle	w
lynett	w
lynette	w
lynn	b
lynna	w
lynne	w
lynnea	w
lynnell	w
lynnelle	w
lynnet	w
lynnett	w
lynnette	w
lynsay	w
lynsey	w
lynton	m
lynwood	m
lyon	m
lyonel	m
lyov	m
lyra	w
lyric	w
lyris	w
lys	w
lysagh	m
lysander	m
lysandra	w
lysanne	w
lysette	w
lysimachos	m
lysistrata	w
lyssa	w
lyuba	w
lyubochka	w
lyubonka	w
lyubov	b
lyudmila	w
lyudmilla	w
lyuha	w
lyutsiana	w
lyyli	w
lázaros	m
lätitia	w
lätizia	w
léa	w
léandros	m
lékos	m
léna	w
léo	m
léon	m
léonard	m
léonce	m
léoni	w
léonne	w
léopold	m
léta	w
lía	w
lína	w
lítsa	w
lörinc	m
maarten	m
mab	w
mabbina	w
mabel	w
mabelle	w
mable	w
mac	m
macaria	w
mace	m
macey	w
macha	w
machi	w
machko	w
machna	w
macie	w
mack	m
mackenzie	m
macy	w
mada	w
madai	m
madalena	w
madalyn	w
maddalena	w
maddi	w
maddie	b
maddox	m
maddy	b
madeira	w
madel	w
madelaine	w
madeleine	w
madelena	w
madelene	w
madelin	w
madelina	w
madeline	w
madella	w
madelle	w
madelon	w
madelyn	w
madge	w
madilyn	w
madisen	w
madison	b
madisyn	w
madita	w
madlaina	w
madleen	w
madleine	w
madlen	w
madlene	w
madlin	w
madonna	w
madra	w
mads	m
mady	w
madyson	w
mae	w
maegan	w
maeve	w
mafalda	w
mag	w
magan	w
magara	w
magarete	w
magda	w
magdaia	w
magdalen	w
magdalena	w
magdalene	w
magdalina	w
magdaliní	w
magena	w
maggee	w
maggi	w
maggie	w
maggy	w
magmeteva	w
magna	w
magnolia	w
magnum	m
magnus	m
magret	w
magrit	w
mahala	w
mahalah	m
mahalath	w
mahali	m
mahalia	w
mahlah	w
mahmoud	m
mahmud	m
mahmut	m
mahtab	w
maia	w
maible	w
maida	w
maiga	w
maighdiln	w
maik	m
maike	w
maila	w
mailin	w
mailo	m
mair	w
maira	w
maire	w
mairin	w
maisey	w
maisie	w
maison	m
maitilde	w
maiya	w
maizah	w
maj	w
maja	w
majandra	w
maje	m
majella	w
major	m
makaila	w
makani	m
makarios	m
makena	w
makenna	w
makhna	w
makoto	m
makrina	w
maks	m
maksim	m
maksimillian	m
maksimina	w
maksimova	w
mal	m
mala	w
malachi	m
malachias	m
malaika	w
malakai	m
malamatenia	w
malana	w
malandra	w
malania	w
malanie	w
malaya	w
malca	w
malchus	m
malchy	m
malcolm	m
malea	w
maleah	w
malena	w
malgorzata	w
malia	w
malik	m
malika	w
malila	w
malin	w
malina	w
malinda	w
malinde	w
malissa	w
malissia	w
maliusha	w
maliuta	w
maliyah	w
malka	w
mallissa	w
mallorie	w
mallory	b
malona	w
maloney	m
malonia	w
malorie	w
malory	w
malou	w
malte	m
malu	w
maluchka	w
malusha	w
malva	w
malvin	m
malvina	w
malvyn	m
malwin	m
malynda	w
malzan	m
mame	w
mamelfa	w
mamie	w
mamika	w
mamo	m
man	m
mana	w
manal	w
manasseh	m
manasses	m
manco	m
mancu	m
manda	w
mandara	w
mandek	m
mandel	m
mander	m
mandi	w
mandie	w
mandisa	w
mandy	w
manechka	w
manfred	m
manfredo	m
mangena	w
mango	m
manja	w
manka	w
manlio	m
mannie	m
manning	m
mannix	m
manny	m
mano	m
manolito	m
manolo	m
manon	w
mansa	m
mansi	w
manu	m
manuel	m
manuela	w
manuele	m
manya	w
manólis	m
manús	m
mar	m
mara	w
marabel	w
marah	w
maraike	w
maralda	w
marana	w
marbert	m
marc	m
marcel	m
marcela	w
marcelia	w
marcell	m
marcella	w
marcelle	w
marcellina	w
marcelline	w
marcellino	m
marcello	m
marcellus	m
marcelo	m
marchall	m
marchelle	w
marci	w
marcia	w
marcie	w
marcile	w
marcille	w
marcin	m
marcius	m
marco	m
marcos	m
marcus	m
marcy	w
marden	m
mareah	w
mareen	w
mareike	w
mareile	w
marek	m
maremiana	w
maren	w
marena	w
maressa	w
marfa	w
marfutka	w
marga	w
margalit	w
margalo	w
margaret	w
margareta	w
margarete	w
margaretha	w
margarethe	w
margaretta	w
margarette	w
margarita	w
margaritha	w
margaux	w
marge	w
margeaux	w
margerita	w
margery	w
marget	w
margette	w
margherita	w
margi	w
margie	w
margit	w
margita	w
margitta	w
margo	w
margot	w
margret	w
margreth	w
margrit	w
margrith	w
marguerite	w
margy	w
marhold	m
mari	w
maria	w
maria-luise	w
maria-theresia	w
mariabella	w
mariah	w
mariam	w
marian	b
mariana	w
mariangela	w
marianka	w
mariann	w
marianna	w
marianne	w
mariano	m
marianskaia	w
mariasha	w
maribel	w
maribelle	w
maribeth	w
marica	w
marice	w
maricha	w
marichinich	w
maridel	w
marie	w
marie-ann	w
marie-jeanne	w
marie-lena	w
marie-lies	w
marie-louise	w
marie-luise	w
marie-rose	w
marie-theres	w
marie-therese	w
marieann	w
mariechen	w
mariejeanne	w
marieke	w
mariel	w
mariela	w
mariele	w
marielene	w
marielies	w
marieliese	w
mariella	w
marielle	w
mariellen	w
marieluise	w
marietheres	w
marietta	b
mariette	w
marigold	w
mariia	w
marija	w
marijan	m
marijn	m
marijo	w
marika	w
marike	w
marilee	w
marilena	w
marilene	w
marilies	w
marilin	w
marilita	w
marille	w
marillin	w
marilu	w
marilyn	w
marilynne	w
marimiana	w
marin	b
marina	w
marine	w
marinella	w
marini	w
marinka	w
marinna	w
marino	m
marinochka	w
marinskaia	w
marinus	m
mario	m
mariola	w
marion	w
marion amanda	w
marionilla	w
mariposa	w
mariquilla	w
maris	w
marisa	w
marisha	w
mariska	w
marisol	w
marissa	w
marit	w
marita	w
maritanna	w
maritsa	w
maritta	w
maritza	w
marius	m
mariusz	m
mariya	w
marj	w
marja	w
marjan	w
marjani	w
marje	w
marjeta	w
marji	w
marjie	w
marjka	w
marjorie	w
marjory	w
marjy	w
mark	m
marka	w
marketa	w
marketta	w
markiana	w
markku	m
marko	m
markos	m
markov	m
markus	m
marla	w
marlane	w
marle	w
marleah	w
marlee	w
marleen	w
marlen	w
marlena	w
marlene	w
marley	w
marlie	w
marlies	w
marliese	w
marlin	m
marline	w
marlis	w
marlise	w
marlo	m
marlon	m
marlow	m
marlowe	m
marlyn	w
marmaduke	m
marmara	w
marna	w
marne	w
marney	w
marni	w
marnia	w
marnie	w
marnin	m
marnina	w
marous	w
marquez	m
marquis	m
marquita	w
marrilee	w
marris	w
marrissa	w
marsh	m
marsha	w
marshal	m
marshall	m
marsiella	w
mart	m
marta	w
martainn	m
martelle	w
martemianova	w
marten	m
martguerita	w
martha	w
marthe	w
marthena	w
marti	w
martica	w
martie	b
martin	m
martina	w
martine	w
martino	m
martita	w
martje	w
martti	m
marty	b
martyn	m
martynne	w
martín	m
marufa	w
marulia	w
maruschka	w
marusya	w
marv	m
marve	m
marvella	w
marven	m
marvin	m
marwin	m
mary	w
marya	w
maryam	w
maryann	w
maryanna	w
maryanne	w
marybelle	w
marybeth	w
maryellen	w
maryjane	w
maryjo	w
maryl	w
maryla	w
marylee	w
marylin	w
marylinda	w
marylka	w
marylou	w
marylynne	w
maryrose	w
marys	w
marysa	w
marzena	w
marzia	w
marzio	m
maría	w
marína	w
marínos	m
masao	m
mascha	w
masha	w
mashenka	w
mashullam	m
masika	w
mason	m
massimiliano	m
massimo	m
mata	m
matai	m
matana	w
matej	m
matelda	w
mateo	m
matern	m
maternus	m
matfeitsa	w
mathe	m
mathea	w
mathew	m
mathian	m
mathias	m
mathieu	m
mathilda	w
mathilde	w
mathis	m
mathäus	m
matias	m
matilda	w
matilde	w
matis	w
mato	m
matope	m
matrena	w
matrika	w
matrona	w
matruna	w
matryoshka	w
mats	m
mats-lennart	m
matsu	w
matt	m
matteo	m
mattes	m
matthaeus	m
mattheus	m
matthew	m
matthias	m
matthieu	m
matthiew	m
matthis	m
matthus	m
matthäus	m
matti	b
mattia	m
mattias	m
mattie	b
mattis	m
matty	b
mattäus	m
matvey	m
matysh	m
matz	m
maud	w
maude	w
maudie	w
maura	w
maure	w
maureen	w
maureene	w
maurene	w
maurice	m
mauricio	m
maurie	m
maurin	m
maurina	w
maurine	w
maurise	b
maurita	w
mauritius	m
maurits	m
mauritz	m
maurizia	w
maurizio	m
mauro	m
maurus	m
maury	m
maverick	m
mavis	w
mavra	w
max	m
maxi	w
maxie	b
maxim	m
maxima	w
maxime	b
maximilian	m
maximiliane	w
maximilianus	m
maximilien	m
maximillian	m
maximo	m
maxine	w
maxwell	m
maxy	b
may	w
may-britt	w
maya	w
maybelle	w
maye	w
mayer	m
mayla	w
maylea	w
maynard	m
mayne	m
maynord	m
mayon	m
mayor	m
mayra	w
mazcho	w
mead	b
meade	b
meadow	w
meagan	w
meaghan	w
meara	w
meave	w
mechelle	w
mechthild	w
mechthilde	w
mechtild	w
meckie	m
meda	w
medea	w
medina	w
medon	m
medora	w
medusa	w
medwyn	m
meena	w
meg	w
megan	w
megara	w
megen	w
meggi	w
meggie	w
meggy	w
meghan	w
meghann	w
mehdi	m
mehetabel	b
mehmet	m
mehtap	w
mei	w
meier	m
meik	m
meike	w
meinhard	m
meinolf	m
meinrad	m
meir	m
meira	w
meirion	m
mekhi	m
mel	b
mela	w
melamie	w
melanctha	w
melancton	m
melani	w
melania	w
melanie	w
melanie cornelia	w
melaniia	w
melantha	w
melany	w
melba	w
melcher	m
melchior	m
melchiorre	m
meldan	m
melek	b
melesa	w
melessa	w
meletina	w
melia	w
melicent	w
melih	m
melina	w
melinda	w
melinde	w
melis	w
melisa	w
melisande	w
melisandra	w
melisenda	w
melisent	w
melissa	w
melisse	w
melita	w
melitina	w
melitta	w
melker	m
mella	w
melle	w
melli	w
mellicent	w
mellie	w
mellisa	w
mellisent	w
melloney	w
melly	w
melodee	w
melodie	w
melody	w
melonie	w
melony	w
melosa	w
melsine	w
melusina	w
melva	w
melvin	m
melvyn	m
melína	w
menachem	m
menard	m
mendel	m
mendie	m
mendy	m
menelaos	m
menora	w
menshikova	w
menélaos	m
mephisto	m
merab	w
meral	w
merari	m
mercedes	w
mercer	m
merci	w
mercie	w
mercy	w
merdyce	w
meredeth	m
meredith	b
meredithe	w
merell	m
meret	w
mergivana	w
meri	w
meridel	w
meridith	w
meriel	w
merilee	w
merill	m
merilyn	w
meris	w
merissa	w
merkur	m
merkureva	w
merl	w
merla	w
merle	b
merlin	m
merlina	w
merline	w
merna	w
merola	w
merralee	w
merrel	m
merrick	m
merridie	w
merrie	w
merrielle	w
merrile	w
merrilee	w
merrili	w
merrill	b
merrily	w
merry	b
mersey	w
mert	m
mertice	w
merv	m
merve	w
mervin	m
merwin	m
merwyn	m
mery	w
meryem	w
meryl	b
mesha	w
meshach	m
messina	w
mesut	m
meta	w
mete	m
metha	w
methune	w
methusalem	m
methuselah	m
metin	m
mette	w
meyer	m
meyler	m
mia	w
miah	w
miakoda	w
mic	m
micaela	w
micah	m
micajah	m
micha	m
michael	m
michael-kai	m
michaela	w
michaele	w
michaelina	w
michaeline	w
michaella	w
michail	m
michal	b
michale	m
michaíl	m
micheal	m
micheil	m
michel	b
michela	w
michelangela	w
michelangelo	m
michele	b
michelina	w
micheline	w
michell	w
michella	w
michelle	w
michiko	w
michális	m
michèle	w
mick	m
mickey	m
micki	w
mickie	b
micky	b
midge	w
midori	w
midoro	m
mieke	w
miesha	w
migina	w
mignon	w
mignonne	w
miguel	m
miguela	w
miguelita	w
mihael	m
mihaly	m
miia	w
miiro	m
mijo	m
mika	b
mikael	m
mikaela	w
mikah	w
mikail	m
mikayla	w
mike	m
mikel	m
mikey	m
mikhail	m
mikhaila	w
mikhailova	w
mikitina	w
mikkel	m
mikko	m
miklos	m
miko	m
mikol	m
mikosch	m
mikula	w
mikulina	w
mikâil	m
mil	w
mila	w
milagros	m
milakhna	w
milan	m
milana	w
milata	w
milava	w
mildred	w
mildrid	w
mile	m
milehva	w
milekha	w
milena	w
milenia	w
milenka	w
miles	m
milesa	w
mileva	w
miley	w
milica	w
milicent	w
miliia	w
milika	w
milios	m
milissent	w
militsa	w
milka	w
mill	m
milla	w
millard	m
milleise	w
miller	m
milli	w
millicent	w
millie	w
millisent	w
milly	w
milo	m
milohna	w
milokhna	w
milos	m
miloslava	w
miloushka	w
milt	m
miltiades	m
miltie	m
miltiádis	m
milton	m
milty	m
miluska	w
milva	w
milzie	w
mimi	w
min	w
mina	w
minda	w
mindy	w
miner	m
minerva	w
minetta	w
minette	w
mingan	m
minka	w
minna	w
minnaminnie	w
minne	w
minni	w
minnie	w
minnnie	w
minny	w
minodora	w
minor	m
minos	m
minta	w
mintha	w
minuro	m
mio	m
miodrag	m
miof mela	w
miquela	w
mira	w
mirabel	w
mirabell	w
mirabella	w
mirabelle	w
mirac	m
miracle	w
miran	b
miranda	w
mirandola	w
miray	w
mirco	m
mireielle	w
mireille	w
mirella	w
mirelle	w
miremba	w
mirena	w
miretta	w
mireya	w
miriam	w
miriam melanie	w
mirielle	w
mirijam	w
mirilla	w
mirja	w
mirjam	w
mirjana	w
mirka	w
mirko	m
mirlinda	w
mirna	w
miro	m
mironova	w
miropiia	w
miroslav	m
miroslava	w
miroslaw	m
miroslawa	w
mirozlava	w
mirra	w
mirta	w
mirya	w
misael	m
mischa	m
misha	b
mishe	m
missie	w
missy	w
misti	w
misty	w
misu	m
mitch	m
mitchael	m
mitchel	m
mitchell	m
mitena	w
mitexi	w
mitrodora	w
mitzi	w
miwa	w
miya	w
miyoko	w
miyuki	w
mizinovskaia	w
mlada	w
mnason	m
moa	w
moab	m
moana	w
modest	m
modesta	w
modestia	w
modestine	w
modesto	m
modestus	m
modesty	w
moe	m
moemu	w
mohamed	m
mohammad	m
mohammed	m
mohandas	m
mohandis	m
moike	w
moiko	w
moina	w
moira	w
moise	m
moises	m
moishe	m
moll	w
mollee	w
molli	w
mollie	w
molly	w
mommy	w
mona	w
monah	w
monca	w
moni	w
monica	w
monika	w
monique	w
monja	w
monro	m
monroe	m
monserrat	w
monta	w
montague	m
montana	w
monte	m
montgomery	m
monti	m
monty	m
moon	w
moore	m
moorish	m
mora	w
morandus	m
morava	w
morawa	w
morcheeba	w
mord	m
mordecai	m
mordy	m
moreen	w
morena	w
moreno	m
morey	m
morgan	b
morgana	w
morgance	w
morgane	w
morganica	w
morganne	w
morgen	b
morgun	m
moria	w
moriah	w
moriarty	m
morie	m
morillo	m
morissa	w
moritz	m
moritz-jakob	m
moriz	m
morla	w
morlee	m
morley	m
morly	m
morna	w
morrie	m
morris	m
morrison	m
morry	m
morse	m
mort	m
morten	m
mortie	m
mortimer	m
morton	m
morty	m
morven	m
morwenna	w
mose	m
moselle	w
moses	m
moshe	m
mosi	m
moss	m
motka	m
mounya	w
mousia	w
movert	m
moyna	w
moyra	w
mozelle	w
mozes	m
mozyr	w
mstislava	w
mstislavliaia	w
mudri	w
muffin	b
mufi	w
mufinella	w
muhammad	m
muharrem	m
muire	w
mulya	w
mund	m
mundan	m
muniia	w
munmro	m
munroe	m
mura	w
murak	m
murat	m
murdoch	m
murdock	m
mureil	w
murial	w
muriel	w
murielle	w
muroniia	w
murphy	m
murray	m
murry	m
murty	m
murvyn	m
musa	m
musidora	w
mustafa	m
muza	w
muzaffer	m
my	b
mya	w
myca	m
mycah	m
mychal	m
myer	m
mylene	w
myles	m
mylo	m
mylène	w
myra	w
myrah	w
myranda	w
myriam	w
myriande	w
myrilla	w
myrjam	w
myrle	w
myrlene	w
myrna	w
myron	m
myrra	w
myrrha	w
myrsini	w
myrta	w
myrtha	w
myrtia	w
myrtice	w
myrtie	w
myrtle	w
myrvyn	m
myrwyn	m
myshka	w
myslna	w
máchi	w
mágda	w
máire	w
máirín	w
mákis	m
mános	m
mára	w
mários	m
márkos	m
máro	w
márton	m
máta	w
mélanie	w
mélissa	w
ménis	m
méri	w
míkis	m
mília	w
mímis	m
mína	w
mínos	m
mítsos	m
mónica	w
na'kesha	w
naamah	b
nabil	m
nabor	m
nacho	m
nacio	m
nada	w
nadab	m
nadav	m
nadean	w
nadeek	w
nadeekovaia	w
nadeen	w
nadege	w
nadejda	w
nadenka	w
nader	m
nadescha	w
nadeschda	w
nadeshda	w
nadezda	w
nadia	w
nadie	w
nadim	m
nadin	w
nadina	w
nadine	w
nadir	m
nadira	w
nadire	w
nadiya	w
nadja	w
nadjenka	w
nadjeshda	w
nadra	w
nady	w
nadya	w
nadyenka	w
nadysha	w
nadyuiska	w
nadège	w
naemi	w
nafsiká	w
nagendra	m
nagesh	m
nagib	m
nagid	m
naglaya	w
nahia	w
nahide	w
nahla	w
nahor	m
nahuel	m
nahum	m
naia	w
naida	w
nail	m
naila	w
nailah	w
nailia	w
naimah	w
naira	w
naitik	m
najib	m
nakita	w
nala	w
nalani	w
naldo	m
nalren	m
namid	m
namik	m
namika	w
namir	m
nan	w
nana	w
nanaia	w
nanami	w
nananne	w
nanashi	w
nance	w
nancee	w
nancey	w
nanci	w
nancie	w
nancy	w
nandag	w
nandan	m
nando	m
nandor	m
nanete	w
nanette	w
nani	w
nanice	w
nanine	w
nanja	w
nanna	w
nannette	w
nanni	w
nannie	w
nanny	w
nanon	w
nanook	m
nantan	m
nantwig	m
nanuk	m
naoise	m
naoki	m
naoma	w
naomi	w
naoya	m
nap	m
napea	w
naphtali	m
napier	m
napoleon	m
nappie	m
nappy	m
nara	w
narayan	m
narca	w
narcisa	w
narciso	m
narciss	m
narcissa	w
narcisso	m
narcissus	m
narda	w
narella	w
narelle	w
narendra	m
nari	w
nariko	w
narinder	m
narkissa	w
narmada	w
narvik	m
nash	m
nashota	w
nasir	m
nasira	w
nasser	m
nastasia	w
nastasich	w
nastasiia	w
nastasja	w
nastassia	w
nastasya	w
nastenka	w
nastia	w
nastiona	w
nastionka	w
nastiusha	w
nastja	w
nastka	w
nastya	w
nasul	m
nasía	w
nat	b
nata	w
natacha	w
natachia	w
natacia	w
natal	m
natala	w
natale	b
natalee	w
natali	w
natalia	w
natalie	w
nataliia	w
natalija	w
natalina	w
nataline	w
natalio	m
natalis	m
nataliya	w
natalja	w
natalka	w
nataly	w
natalya	w
natanael	m
natanaele	m
nataniel	m
nataniella	w
natasa	w
natascha	w
natasha	w
natashenka	w
natashia	w
natasia	w
natassia	w
nate	m
natesa	w
nathalia	w
nathalie	w
nathan	m
nathanael	m
nathanha	w
nathania	w
nathanial	m
nathaniel	m
nathanil	m
nathasha	w
nathen	m
natille	w
natisha	w
natividad	w
natka	w
natsuko	w
natsumi	w
natty	b
naum	m
nausikaa	w
nava	w
naveed	m
navid	m
nawra	w
nayeli	w
nayla	w
naysa	w
nazaire	m
nazan	w
nazar	m
nazario	m
nazariy	m
nazarova	w
nazim	m
nazli	w
nea	w
neacail	m
neacel	m
neal	m
neala	w
neale	m
neall	m
nealon	m
nealson	m
nealy	m
neasa	w
neassa	w
nebojsa	m
nebracha	w
nebraga	w
nebukadnezar	m
necati	m
neci	w
necla	w
neculai	m
ned	m
neda	w
nedana	w
nedda	w
neddie	m
neddy	m
nedelia	w
nedi	w
nediva	w
neea	w
neece	m
neel	m
neele	w
neely	b
nefen	m
nefertari	w
nefertiti	w
neha	w
nehemia	m
nehemiah	m
neifion	m
neil	m
neila	w
neile	w
neilina	w
neill	m
neilla	w
neille	w
neils	m
neirin	m
nekane	w
nekoda	m
nekrasa	w
nekrasia	w
nektaría	w
nektários	m
nela	w
nelda	w
nele	w
nelek	m
nelia	w
nelie	w
nelieta	w
neliuba	w
nell	w
nella	w
nelle	w
nelli	w
nellie	w
nelly	w
nels	m
nelson	m
nelu	m
nemanja	m
nemesis	w
nemilka	w
nemka	w
nemo	m
nena	w
nenad	m
neo	m
neola	w
neoma	w
neona	w
neonila	w
neoptolemus	m
nephele	w
nepomuk	m
neptun	m
neptune	m
nerea	w
nereida	w
nereus	m
nereza	w
neria	w
neriah	m
nerida	w
nerina	w
nerine	w
nerio	m
nerissa	w
nerita	w
nermin	w
nero	m
neroli	w
neron	m
nert	w
nerta	w
nerte	w
nerti	w
nertie	w
nerty	w
nerva	m
nerys	w
nesdits	w
nese	w
nesha	w
neslihan	w
nesrin	w
ness	w
nessa	w
nessaja	w
nessi	w
nessia	w
nessie	w
nessy	w
nesta	w
nestario	m
nester	m
nestor	m
nestore	m
nestori	m
nesy	w
neta	w
nethaniah	m
netia	w
netis	m
netka	w
netta	w
netti	w
nettie	w
nettle	w
netty	w
netuno	m
nev	m
neva	w
nevada	w
nevaeh	w
nevan	m
neve	w
neven	m
nevenka	w
neves	w
nevil	m
nevile	m
neville	m
nevin	b
nevins	m
nevio	m
nevsa	w
newt	m
newton	m
neysa	w
neza	w
nezhatok	w
nezhdakha	w
nezhka	w
nezihe	w
nia	w
nial	m
niall	m
nibelung	m
nic	m
nicanor	m
niccel	w
niccolo	m
niccolò	m
nice	w
nichjo	m
nichol	b
nichola	w
nicholas	m
nichole	b
nicholle	w
nichols	m
nicia	w
nick	m
nickey	m
nicki	w
nickie	b
nicklas	m
nicko	m
nickola	m
nickolai	m
nickolas	m
nickolaus	m
nicky	b
niclas	m
nico	m
nicodemo	m
nicodemus	m
nicol	b
nicola	b
nicolaas	m
nicolai	m
nicolais	m
nicolao	m
nicolaos	m
nicolas	m
nicolasa	w
nicolau	m
nicolaus	m
nicole	w
nicolea	w
nicoleta	w
nicoletta	w
nicolette	w
nicoli	w
nicolina	w
nicoline	w
nicolis	m
nicolle	w
nicolo	m
nicolò	m
nicomedes	m
nicomedo	m
nicostrato	m
nicu	m
nicusor	m
nidia	w
niel	m
niels	m
niema	m
nieve	w
nifantova	w
nigel	m
nigelia	w
nigella	w
niilo	m
nik	m
nika	w
nikandros	m
nikaniki	w
nike	b
nikeisha	w
nikephoros	m
nikhil	m
nikhila	w
niki	b
nikias	m
nikifor	m
nikiforova	w
nikifóros	m
nikita	b
nikitina	w
nikki	b
nikkie	w
nikkylia	w
niklas	m
niklaus	m
niko	m
nikodemos	m
nikodemus	m
nikodim	m
nikola	b
nikolaas	m
nikolai	m
nikolaj	m
nikolao	m
nikolaos	m
nikolas	m
nikolaus	m
nikolena	w
nikoleta	w
nikolett	w
nikoletta	w
nikolia	w
nikolina	w
nikoline	w
nikolos	m
nikolétta	w
nikomachos	m
nikomedes	m
nikon	m
nikos	m
nikostratos	m
niksha	w
nikólaos	m
nikólas	m
nil	b
nila	w
nilay	w
nilda	w
niles	m
nilgün	w
nilhan	w
nils	m
nils-matti	m
nils-merten	m
nilson	m
nilüfer	w
nimah	w
nimbus	m
nimfodora	w
nimrod	m
nina	w
ninel	w
ninetta	w
ninette	w
ninian	m
ninina	w
ninja	w
ninnetta	w
ninnette	w
nino	m
ninockha	w
ninon	w
ninotchka	w
niobe	w
nioclás	m
nira	w
niranjan	m
nirel	m
nirvana	w
nirvelli	w
nirvita	w
nisa	w
nishan	m
nishant	m
nishi	w
nisi	w
nissa	w
nisse	w
nissie	w
nissy	w
nita	w
nitara	w
nitasha	w
nitca	w
nithya	w
nitin	m
nituna	w
nitya	w
nitzana	w
nivek	m
niven	m
nixie	w
nizana	w
nizar	m
njord	m
noa	b
noach	m
noadiah	m
noah	m
noah-max	m
noak	m
noam	m
noami	w
nobe	m
nobie	m
noble	m
noby	m
nodin	m
noe	m
noel	b
noela	w
noelani	w
noele	w
noelene	w
noelia	w
noell	w
noella	w
noelle	w
noellyn	w
noelyn	w
noemi	w
nofretete	w
nogah	w
nohemi	w
nokomis	w
nola	w
nolan	m
nolana	w
noland	m
noleen	w
nolene	w
nolie	w
nolik	m
noll	m
nollie	b
nolly	m
nolwenn	w
nomi	w
nomiki	m
nomusa	w
nona	w
nonah	w
noni	w
nonie	w
nonna	w
nonnah	w
nooa	m
noora	w
nora	w
norah	w
norbert	m
norbie	m
norby	m
norean	w
noreen	w
norene	w
nori	w
noriko	w
norina	w
norine	w
norm	m
norma	w
norman	m
normand	m
normie	m
normina	w
normy	m
norri	w
norrie	b
norris	m
norry	b
north	m
northrop	m
northrup	m
norton	m
norwin	m
norwood	m
nostasia	w
notburga	w
notker	m
noton	m
nova	w
novalis	m
novelia	w
novia	w
novio	m
nowell	m
noé	m
noémie	w
noël	m
noëlle	w
ntína	w
ntínos	m
nuala	w
nubia	w
nudd	m
nuncius	m
nunekhiia	w
nuno	m
nunzia	w
nunziatina	w
nunzio	m
nura	w
nuran	w
nuray	w
nurcan	m
nurettin	m
nurhan	w
nuri	m
nuria	w
nurija	w
nuriye	w
nurten	w
nuru	m
nya	w
nyah	w
nyala	w
nyarai	w
nyasia	w
nydia	w
nye	m
nyla	w
nyle	m
nyssa	w
nyura	w
nyusha	w
nyx	w
nákos	m
nánsi	w
nása	w
násos	m
néki	w
níka	w
níki	w
níkos	m
nítsa	w
nóirín	w
nópi	w
oada	w
oakes	m
oakley	m
oana	w
oanez	w
oates	m
obadiah	m
obadias	m
obed	m
obediah	m
obelia	w
obelix	m
oberon	m
obi	m
obialulu	m
obidiah	m
obie	m
obra	w
obrad	m
obrezkova	w
oby	m
oceana	w
ochen	m
octavia	w
octavian	m
octavio	m
octavius	m
océane	w
oda	w
odalis	w
odalys	w
odd	m
oddmund	m
oddvar	m
ode	m
odea	w
oded	m
odeda	w
odele	w
odelette	w
odelia	w
odelinda	w
odelinde	w
odell	m
odella	w
odelle	w
odera	w
odessa	w
odetta	w
odette	w
odey	m
odharnait	w
odhiambo	m
odhrán	m
odie	m
odigitriia	w
odil	m
odile	w
odilia	w
odilie	w
odille	w
odilo	m
odilon	m
odin	m
odina	w
odintsova	w
odion	m
odo	m
odoacer	m
odon	m
odovacar	m
odran	m
ody	m
odysseus	m
odysséas	m
oenone	w
ofce	w
ofelia	w
ofella	w
ofer	m
ofilia	w
ofimia	w
ofira	w
ofra	w
ofydd	m
ogafia	w
ogafitsa	w
ogashka	w
ogdan	m
ogden	m
ogdon	m
ogilvy	m
ognian	m
ognyan	m
ografena	w
ogrifina	w
ogrofena	w
ogrufena	w
ogrufina	w
oguz	m
ohanna	w
ohin	m
ohto	m
oihana	w
oili	w
oisin	m
oiva	m
okan	m
okay	m
okelani	w
oki	w
okinfieva	w
okka	w
oksana	w
oksanochka	w
okseniia	w
oksinia	w
oksiutka	w
oktyabrina	w
okulina	w
ola	b
olaf	m
olag	m
olalla	w
olamide	w
olathe	w
olav	b
olavi	m
olavo	m
olayinka	w
olcay	b
olderico	m
oldrich	m
ole	m
olechka	w
oleg	m
olek	m
oleksander	m
oleksandra	w
oleksyi	m
olena	w
olenitsa	w
olenka	w
olenolin	m
oleos	m
olesia	w
olethea	w
olev	m
olezka	m
olf	m
olfereva	w
olga	w
olginitsa	w
olgirdovna	w
olgov	w
oli	m
olia	w
oliana	w
olier	m
olimpia	w
olimpiada	w
olin	m
olinda	w
olisa	w
olisava	w
olive	w
oliver	m
olivera	w
olivero	m
olivet	w
olivette	w
olivia	w
olivie	w
olivier	m
oliviero	m
oliwia	w
oliy	w
olk	m
olkha	w
olle	m
olli	m
ollie	b
olly	b
olof	m
olorande	w
olov	m
olova	w
olrugo	m
olta	w
olufemi	m
olukayode	m
olushola	m
olva	w
olvan	m
olwen	w
olwin	w
olya	w
olymbía	w
olympe	w
olympia	w
olympie	w
olympiodoros	m
olympos	m
olympus	m
olyvia	w
olzhbeta	w
om	m
omar	m
omari	m
omarion	m
omarjeet	m
omega	w
omelfa	w
omer	m
omero	m
omid	m
omolara	w
ompoly	m
omri	m
ona	w
onawa	w
ond	m
ondra	b
ondrea	w
ondreiana	w
ondrej	m
ondwina	w
oneida	w
onenn	w
onesimus	m
onesiphorus	m
oney	m
onfre	m
onfroi	m
oni	b
onida	w
onisim	m
onni	m
onofredo	m
onora	w
onoria	w
onoslava	w
ontonia	w
ontsiforova	w
ontsyforova	w
onur	m
ony	m
onyeka	w
oona	w
opal	w
opalina	w
opaline	w
ophelia	w
ophelie	w
ophira	w
ophiuchus	m
ophrah	w
ophélie	w
oprah	w
oprosiniia	w
optatus	m
ora	w
oral	m
oralee	w
oralia	w
oralie	w
oralla	w
oralle	w
oran	m
orane	w
orania	w
orazio	m
orbadiah	m
orbán	m
orel	b
orelano	m
orelee	w
orelia	w
orelie	w
orelio	m
orelious	m
orell	m
orella	w
orelle	w
oren	m
orenda	w
orenka	w
orest	m
oreste	m
orestes	m
orfeo	m
orféas	m
orféfs	m
orhan	m
ori	m
oria	w
oriana	w
oriane	w
orianna	w
orianne	w
oribel	w
oriel	b
orin	m
orina	w
orinda	w
oriole	w
orion	m
orkény	m
orla	w
orlan	m
orland	m
orlanda	w
orlando	m
orlantha	w
orlena	w
orlenda	w
orlitza	w
orly	w
orman	m
ormerod	m
ormond	m
ormos	m
orna	w
ornella	w
oro	m
oroitz	m
orpheus	m
orran	m
orrel	m
orrell	m
orren	m
orrin	m
ors	m
orsa	w
orsha	w
orshinaia	w
orsina	w
orsino	m
orso	m
orsola	w
orsolya	w
orson	m
ortemeva	w
ortensia	w
ortensio	m
ortfried	m
orton	m
ortrud	w
ortrun	w
ortwin	m
orunjan	m
orv	m
orva	w
orval	m
orvar	m
orville	m
orvin	m
orya	w
oréstis	m
osama	m
osamu	m
osanna	w
osanne	w
osaze	m
osbaldo	m
osbert	m
osborn	m
osborne	m
osbourn	m
osbourne	m
oscar	m
osgood	m
osheen	m
osher	m
osip	m
osipova	w
osiris	m
oskar	m
oskari	m
osku	m
osliabia	w
osman	m
osme	w
osmond	m
osmund	m
ossian	m
ossie	m
ostafia	w
ostankova	w
ostashkova	w
osvaldo	m
oswald	m
oswell	m
oswin	m
osyenya	w
otakar	m
otes	m
otfried	m
otha	w
othelia	w
othella	w
othello	m
othilia	w
othilie	w
othmar	m
othniel	m
otho	m
othon	m
otieno	m
otis	m
otmar	m
otokar	m
otso	m
ottavia	w
ottaviano	m
ottavio	m
ottfried	m
ottilia	w
ottilie	w
ottmar	m
otto	m
ottokar	m
ottomar	m
otávio	m
ouranos	m
ouray	m
ovadia	m
ovdeeva	w
ovdiukha	w
ovdokea	w
ovdotia	w
ovdotitsa	w
ove	b
oved	m
ovid	m
ovidio	m
ovtsa	w
owain	m
owald	m
owen	m
oxana	w
oxford	m
oya	w
oz	m
ozan	m
ozaner	m
ozor	m
ozzie	m
ozzy	m
paavo	m
pabiyan	m
pablo	m
pabloma	w
paca	w
pace	m
pacifica	w
packston	m
paco	m
pacorro	m
paddie	m
paddy	m
padget	m
padgett	m
padma	w
padraic	m
padraig	m
padriac	m
page	b
pagol	m
pagóna	w
paige	b
pail	m
paisley	w
paisís	m
paka	w
paki	m
pakuna	w
paladia	w
palasha	w
palila	w
pall	m
pallas	w
pallu	m
palm	m
palmer	m
palmiera	w
palmira	w
palmiro	m
paloma	w
pam	w
pamela	w
pamelia	w
pamelina	w
pamella	w
pamila	w
pamina	w
pammi	w
pammie	w
pammy	w
pan	m
panagiota	w
panagióta	w
panagiótis	m
panaís	m
pancha	w
panchito	m
pancho	m
pancrazio	m
panda	w
pandita	w
pandora	w
panfilo	m
panfilova	w
panja	w
pankratius	m
panni	w
panos	m
pansemna	w
pansie	w
pansy	w
pantaleone	m
pantalus	m
pantelís	m
panthea	b
pantislava	w
pantyslawa	w
panya	w
paola	w
paolina	w
paolino	m
paolo	m
papagena	w
papageno	m
paphnutius	m
papylus	m
paquita	w
paquito	m
par	m
paraaha	w
paramita	w
paramona	w
paraschiva	w
parasha	w
parasia	w
paraskevi	w
paraskeví	w
paraskova	w
paraskovga	w
paraskovgiia	w
paraskovia	w
paraskoviia	w
pari	w
paride	m
parinor	m
paris	b
parisa	w
parissa	w
park	m
parke	m
parker	m
parlan	m
parlina	w
parmita	w
parnel	w
parnell	m
paroskova	w
parphilie	w
parrnell	m
parry	m
pars	m
parsifal	m
parthenia	w
parthenope	w
parthenópi	w
parthéna	w
parvana	w
parvati	w
parveen	w
parvin	w
parzifal	m
pascal	m
pascale	b
pascaline	w
pascual	m
pascuala	w
pasha	w
pasi	m
pasquale	m
pasqualina	w
pasqualino	m
pastora	w
pat	b
patamon	m
pate	m
paten	m
patia	w
patience	w
patin	m
paton	m
patric	m
patrica	w
patrice	b
patricia	w
patricio	m
patricius	m
patrick	m
patrik	m
patrizia	w
patrizio	m
patrizius	m
patroklus	m
patrova	w
patrycja	w
patryk	m
patsy	b
patten	m
patti	w
pattie	b
pattin	m
patton	m
patty	b
paul	m
paul-gerhard	m
paul-heinz	m
paula	w
paule	w
paulene	w
pauletta	w
paulette	w
pauli	b
paulie	b
paulin	m
paulina	w
pauline	w
paulinus	m
paulita	w
paulo	m
paulus	m
pauly	b
pavel	b
pavia	w
pavipv	m
pavla	w
pavlik	m
pavlina	w
pavlo	m
pavlos	m
pavlov	m
pavlova	w
pavloveia	w
pavlusha	b
pavlushka	m
pavlya	m
pawel	m
pax	w
paxon	m
paxton	m
payat	m
payne	m
payton	m
pazia	w
pchuneia	w
peace	w
peadar	m
pearce	m
pearl	w
pearla	w
pearle	w
pearlie	w
pearline	w
peary	w
pebrook	m
pechta	w
peder	m
pedro	m
peer	m
peg	w
pegeen	w
peggi	w
peggie	w
peggy	w
peigi	w
peirce	m
pekka	m
pelaga	w
pelageia	w
pelageya	w
pelagia	w
pelagiia	w
pelagius	m
pelagía	w
pelias	m
pelin	w
pelle	m
pellegrino	m
pemba	w
pembroke	m
pen	b
penda	w
penelopa	w
penelope	w
penina	w
peninna	w
peninnah	w
penka	w
penn	m
penni	w
pennie	b
pennina	w
penny	b
penrod	m
penthea	w
pentti	m
peony	w
pepablo	m
pepca	w
pepe	m
pepi	w
pepillo	m
pepino	m
pepita	w
pepito	m
peppina	w
peradan	m
perceval	m
perchta	w
percival	m
percy	m
perdia	w
perdita	w
peredeslava	w
peregrina	w
perele	w
pergamos	m
peri	w
peria	w
perice	m
perikles	m
periklís	m
perino	m
perkhta	w
perkhte	w
perkin	m
perl	w
perla	w
perle	w
perlie	w
perlita	w
permelia	w
permine	w
pernel	w
pernell	m
pernilla	w
pernille	w
pero	m
peronel	w
perpetua	w
perpetuia	w
perren	m
perri	w
perrine	w
perry	b
persephone	w
persis	w
pertti	m
períandros	m
pet	w
peta	w
petar	m
pete	m
petek	w
petenka	m
peter	m
peter-michael	m
peterus	m
petey	m
petia	w
petr	m
petra	w
petranella	w
petrea	m
petrina	w
petrona	w
petronella	w
petronia	w
petronila	w
petronilla	w
petronille	w
petros	m
petrov	m
petrova	w
petrovna	w
petrus	m
petsa	w
petteri	m
petula	w
petunia	w
petya	b
peyter	m
peyton	b
peza	w
phaedra	w
phaidra	w
phebe	w
phedra	w
phelan	m
phelia	w
phemie	w
pheobe	w
pheodora	w
phil	b
philadelphia	w
philana	w
philander	m
philbert	m
phile	w
philemon	m
philetus	m
philibert	m
philine	w
philip	m
philipa	w
philipp	m
philippa	w
philippe	m
philippina	w
philippine	w
philippos	m
philippus	m
philis	w
phillida	w
phillie	w
phillip	m
phillipa	w
phillipe	m
phillipp	m
phillis	w
philly	w
philomela	w
philomena	w
phineas	b
phip	m
phoebe	w
phoena	w
phoenix	m
phoibe	w
photine	w
phylicia	w
phylis	w
phyliss	w
phyllida	w
phyllis	w
phyllys	w
phylys	w
phöbe	w
pia	w
piama	w
piata	w
pickwick	m
piedad	w
pier	w
piera	w
pierce	m
pierette	w
pierina	w
piero	m
pierre	m
pierrette	w
pierrine	w
pierson	m
piet	m
pieter	m
pietra	w
pietrek	m
pietrina	w
pietro	m
pietronella	w
piety	w
piggy	m
pihla	w
piina	w
pikka	w
pilan	m
pilar	w
pili	b
pilvi	w
piminova	w
pina	w
pincas	m
pinchas	m
pincus	m
pinelópi	w
pinja	w
pinkas	m
pino	m
pinocchio	m
pio	m
piotr	m
pip	m
piper	w
pippa	w
pippilotta	w
pippin	m
pippo	m
pippy	w
pipra	w
pipsa	w
piri	w
piritta	w
pirjo	w
pirkka	w
pirkko	w
pirmin	m
piro	m
piroschka	w
piroska	w
pirueva	w
pius	m
pixie	w
placida	w
placide	w
placido	m
placidus	m
plakida	w
platon	m
platonida	w
pleasance	w
plektrudis	w
plinio	m
pluto	m
pocahontas	w
pokinaria	w
pola	w
poladia	w
polazhitsa	w
poldi	m
polia	w
polikseniia	w
polina	w
polinaria	w
poliuzhaia	w
pollie	w
pollux	m
polly	w
pollyanna	w
poloma	w
polona	w
poloneika	w
polotsk	w
polotska	w
poloudnitsa	w
polovinova	w
polter	m
poly	w
polybos	m
polyhymnia	w
polykarp	m
polymnia	w
polyxenia	w
polyxéni	w
polína	w
polývios	m
pomnislavka	w
pomona	w
pompejus	m
pompeo	m
pompliia	w
ponaria	w
poni	w
pontianus	m
pontius	m
pontus	m
ponzio	m
pooh	b
pooja	w
poornima	w
popi	w
popliia	w
popova	w
poppy	w
porfirio	m
poroskova	w
porphyrios	m
port	m
porter	m
portia	w
portie	m
porty	m
poseidon	m
posie	w
posy	w
potiphar	m
poul	m
poved	w
powell	m
praise	w
pranav	m
praskoviya	w
praskovja	w
praskovya	w
pratibha	w
pratima	w
praxia	w
prebrana	w
precious	w
predslava	w
predyslava	w
preeti	w
preia	w
preksedys	w
prema	w
premislava	w
pren	m
prent	m
prentice	m
prentiss	m
prepedigna	w
prescott	m
presthlava	w
preston	m
pretiosa	w
priamos	m
priba	w
pribyslava	w
price	m
priia	w
prikseda	w
prikt	m
prima	w
primitiva	w
primo	m
primrose	w
primula	w
prince	m
princess	w
prinz	m
pris	w
prisca	w
priscella	w
priscilla	w
priska	w
priskilla	w
priskula	w
prissie	w
prissy	w
pristine	w
priya	w
prochorus	m
proksha	w
prometheus	m
proniakina	w
prosdoka	w
proserpina	w
proskudiia	w
prospero	m
pru	w
prudence	w
prudentia	w
prudenzio	m
prudi	w
prudy	w
prue	w
prunella	w
pryce	m
przhibislava	w
przybyslawa	w
psyche	w
ptolema	w
ptolemy	m
publius	m
puff	m
pukhleriia	w
pulkheriia	w
pulmu	w
pumpernickel	m
pumuckl	m
puna	w
purcell	m
purdie	w
pushpa	w
puteshineia	w
putnam	m
putnem	m
putok	w
putokoveia	w
pygmalion	m
pyotr	m
pyrena	w
pyrrha	w
pyrrhus	m
pythagoras	m
pythia	w
pános	m
páris	m
pátra	w
péris	m
pétros	m
pópi	w
qabil	m
qadim	m
qadir	m
qadira	w
qamar	m
qamra	w
qasim	m
qiana	w
qimat	m
qismat	m
qitura	w
quabena	w
quade	m
quadriga	w
quan	m
quanah	m
quang	m
quanika	w
quanion	m
quanna	w
quant	m
quantas	m
quartilla	w
quasim	m
quasimodo	m
quax	m
qubilah	w
qudamah	m
queen	w
queena	w
queenie	w
quella	w
quenby	w
quendan	m
quendy	w
quenia	w
quenna	w
quennel	m
quennell	m
quent	m
quentin	b
querida	w
querido	m
quesca	w
questa	w
quiana	w
quianna	w
quidel	m
quigley	m
quill	m
quilla	w
quillan	m
quim	m
quimby	m
quin	m
quinby	m
quincey	m
quincy	m
quinella	w
quinlan	m
quinn	b
quinny	w
quint	m
quinta	w
quintalina	w
quintana	w
quintella	w
quinten	m
quintessa	w
quintilla	w
quintin	m
quintina	w
quinton	m
quintus	m
quique	m
quiriakus	m
quirin	m
quirina	w
quirino	m
quirinus	m
quirita	w
quisha	w
quiterie	w
quito	m
quon	m
quoopy	w
quorra	w
quwatha	w
rab	m
raban	m
rabanus	m
rabbi	m
rabea	w
rabi	m
rabiye	w
rachael	w
rachel	w
rachele	w
rachelle	w
rad	m
rada	w
radcliff	m
radcliffe	m
raddie	m
raddy	m
radella	w
radia	w
radinka	w
radivilovna	w
radka	w
radman	m
radmila	w
radmilla	w
rado	w
radok	w
radokhna	w
radokovaia	w
radomil	m
radonia	w
radosha	w
radoslava	w
radosta	w
radoste	w
radozte	w
radslava	w
radulf	m
rae	w
raeann	w
raeka	w
raf	w
rafa	w
rafael	m
rafaela	w
rafaelia	w
rafaelita	w
rafaellle	m
rafaello	m
rafe	m
rafet	m
raff	m
raffael	m
raffaela	w
raffaele	m
raffaella	w
raffaello	m
raffarty	m
rafferty	m
rafi	m
ragna	w
ragnar	m
ragneda	w
ragosna	w
rahab	w
rahal	w
rahel	w
rahil	w
rahul	m
raidon	m
raik	m
raika	w
raimonda	w
raimondo	m
raimund	m
raimundo	m
raina	w
raine	w
rainer	m
rainhard	m
raini	m
rainier	m
raisa	w
raissa	w
raiza	w
raizel	w
raja	w
rajna	w
rakel	w
rakhiel	w
raku	w
raleigh	m
ralf	m
ralf-dieter	m
ralf-peter	m
ralina	w
ralloú	w
ralph	m
raluca	w
ram	m
ramazan	m
ramiro	m
ramo	m
ramon	m
ramona	w
ramonda	w
ramsay	m
ramsey	m
ramya	w
rana	w
rance	m
rancell	m
rand	m
randa	w
randal	m
randall	m
randee	w
randell	m
randene	w
randi	b
randie	b
randolf	m
randolph	m
randy	b
rane	w
ranee	w
ranen	m
ranger	m
rani	w
rania	w
ranice	w
raniero	m
ranique	w
ranita	w
rank	m
ranka	w
ranna	w
ranon	m
ransell	m
ransom	m
raoul	m
raphael	m
raphaela	w
rapunzel	w
raquel	w
raquela	w
raquelo	m
rashad	m
rashid	m
rashida	w
rasia	w
rasine	w
rasla	w
rasmus	m
rasputin	m
rasso	m
rateral	m
ratka	w
ratslava	w
rauert	m
raugund	w
raul	m
rauno	m
raven	w
ravi	m
ravid	m
ravish	m
raviv	m
rawley	m
rawnie	w
ray	b
raya	w
rayan	m
raychel	w
raye	w
raymond	m
raymund	m
raymundo	m
rayna	w
raynard	m
raynell	w
rayner	m
raynor	m
rayshell	w
rea	w
read	m
reade	m
reagan	m
reagen	m
reamonn	m
reanna	w
reba	w
rebbecca	w
rebe	w
rebeca	w
rebecca	w
rebecka	w
rebeka	w
rebekah	w
rebekka	w
rebekkah	w
recep	m
rechhild	w
rechkina	w
red	m
redd	m
redford	m
redmond	m
ree	w
reeba	w
reece	m
reed	m
reena	w
rees	m
reese	b
reeta	w
reeva	w
reeve	m
refika	w
reg	m
regan	b
regen	m
reggi	w
reggie	b
reggis	m
reggy	m
regina	w
reginald	m
reginauld	m
regine	w
regis	m
regula	w
reicza	w
reid	m
reidar	m
reider	m
reidun	w
reiko	b
reilly	b
reimar	m
reimara	w
reimer	m
reimund	m
reina	w
reinald	m
reinaldo	m
reinaldos	m
reine	w
reiner	m
reingard	b
reinhard	m
reinhardt	m
reinhart	m
reinhild	w
reinhilde	w
reinhold	m
reinold	m
reinwald	m
reisha	w
rejana	w
reka	w
relinde	w
relindis	w
rem	m
remi	m
remigio	m
remigius	m
remington	m
remo	m
remus	m
remy	b
rena	w
renado	m
renae	w
renaldo	m
renard	m
renata	w
renate	w
renato	m
renaud	m
renault	m
rendor	m
rene	b
renee	w
renell	w
renelle	w
renette	w
reni	w
renie	w
renja	w
rennie	w
renny	b
reno	m
renu	m
renza	w
renzo	m
rené	m
renée	w
reshunda	w
resi	w
reta	w
retha	w
reto	m
reube	m
reuben	m
reuel	m
reuven	m
revelin	m
revkah	w
rex	m
rey	b
reyhan	b
reyna	w
reynaldo	m
reynard	m
reynaud	m
reynold	m
reynolds	m
reza	m
rezzo	m
rhea	w
rheba	w
rheta	w
rhett	m
rhetta	w
rhiamon	w
rhianna	w
rhiannon	w
rhianon	w
rhoda	w
rhodanthe	w
rhodes	m
rhodia	w
rhodie	w
rhody	w
rhona	w
rhonda	w
rhyanna	w
rhys	m
ria	w
riane	w
rianna	w
riannon	w
rianon	w
ribona	w
ric	m
rica	w
ricard	m
ricarda	w
ricardo	m
ricca	w
riccarda	w
riccardo	m
rice	m
rich	m
richard	m
richardo	m
richart	m
richca	w
richella	w
richica	w
richie	m
richika	w
richikha	w
richmond	m
richmound	m
richtca	w
richy	m
richza	w
rici	w
rick	m
rickard	m
rickert	m
rickey	m
ricki	b
rickie	b
ricky	b
rico	m
ricoriki	m
rider	m
ridgeley	m
rieke	w
rienzo	m
rifat	m
rigby	m
rigo	m
rigoberto	m
rihana	w
riita	w
rik	m
rika	w
rike	w
riki	w
rikki	b
riko	m
riksa	w
riku	m
rikuentti	m
riley	b
rima	w
rimon	m
rina	w
rinaldo	m
ring	m
ringo	m
rino	m
riobard	m
riocard	m
riona	w
riordan	m
rip	m
ripley	m
ripsimia	w
risa	w
rishanna	w
rishon	m
rishona	w
rislava	w
risto	m
rita	w
ritchie	m
riva	w
rivalee	w
river	m
rivi	w
rivkah	w
rivy	w
rixa	w
riya	w
riza	m
rizpah	w
roald	m
roana	w
roanna	w
roanne	w
roarke	m
rob	m
robak	m
robb	m
robbert	m
robbi	w
robbie	b
robbin	w
robby	b
robbyn	w
robena	w
robenia	w
robers	m
robert	m
roberta	w
roberte	w
robertina	w
roberto	m
robin	b
robina	w
robinet	b
robinett	w
robinetta	w
robinette	w
robinia	w
robinson	m
roby	w
robyn	w
rocco	m
roch	b
rochell	w
rochella	w
rochelle	w
rochester	m
rochette	w
rochus	m
rock	m
rockey	m
rockie	m
rockwell	m
rocky	m
rod	m
roda	w
rodan	m
rodd	m
roddie	m
roddy	m
roderic	m
roderich	m
roderick	m
roderigo	m
roderik	m
rodge	m
rodger	m
rodi	w
rodie	w
rodina	w
rodman	m
rodney	m
rodolfo	m
rodolph	m
rodolphe	m
rodrick	m
rodrigo	m
rodrique	m
rog	m
rogan	m
rogelio	m
roger	m
rogerio	m
rogers	m
rogned	w
rohan	m
rohanna	w
roi	m
rois	w
roksana	w
roland	m
rolanda	w
rolando	m
roldan	m
roley	m
rolf	m
rolf-dieter	m
rolf-peter	m
rolfe	m
rolland	m
rollie	m
rollin	m
rollins	m
rollo	m
rolph	m
roma	m
romain	m
romaine	w
roman	m
romana	w
romane	w
romano	m
romanovna	w
romeo	m
romero	m
romi	w
romika	w
romilda	w
romina	w
romochka	m
romola	w
romolo	m
romona	w
romonda	w
romuald	m
romualdo	m
romulus	m
romun	m
romy	w
román	m
ron	m
rona	w
ronald	m
ronalda	w
ronan	m
ronda	w
rondrigo	m
roni	m
ronica	w
ronja	w
ronna	w
ronni	w
ronnica	w
ronnie	b
ronny	b
roobbie	w
rooney	m
roope	m
roosa	w
roosevelt	m
rora	w
rori	w
rorie	w
rorke	m
rory	b
ros	w
rosa	w
rosa-maria	w
rosabel	w
rosabella	w
rosabelle	w
rosaire	m
rosalba	w
rosaleen	w
rosalia	w
rosalie	w
rosalind	w
rosalinda	w
rosalinde	w
rosaline	w
rosalyn	w
rosalynd	w
rosamond	w
rosamund	w
rosamunde	w
rosana	w
rosangela	w
rosanna	w
rosanne	w
roscislawa	w
rosco	m
roscoe	m
rose	w
rose-marie	w
roseann	w
roseanna	w
roseanne	w
rosel	w
roselia	w
roselin	w
roselinde	w
roseline	w
rosella	w
roselle	w
rosemaria	w
rosemarie	w
rosemary	w
rosemonde	w
rosene	w
rosetta	w
rosette	w
roshelle	w
rosi	w
rosie	w
rosina	w
rosinante	w
rosine	w
rosita	w
rosl	w
roslava	w
roslyn	w
rosmarie	w
rosmerta	w
rosmunda	w
ross	m
rossella	w
rossie	m
rossitza	w
rossy	m
rostislava	w
roswin	m
roswita	w
roswitha	w
rosy	w
roth	m
rotraud	w
rotraut	w
rourke	m
rouven	m
rouvin	m
rovena	w
row	w
rowan	m
rowe	w
rowen	m
rowena	w
rowland	m
rowney	m
roxana	w
roxane	w
roxanna	w
roxanne	w
roxi	w
roxie	w
roxine	w
roxy	w
roxáni	w
roy	m
royal	m
royall	m
royce	m
roz	w
roza	w
rozalia	w
rozalie	w
rozalin	w
rozamond	w
rozanna	w
rozanne	w
roze	w
rozele	w
rozella	w
rozelle	w
rozgneda	w
rozhneva	w
rozina	w
roúla	w
rriocard	m
rube	m
ruben	m
rubetta	w
rubi	w
rubia	w
rubie	w
rubin	m
rubina	w
ruby	b
rudd	m
ruddie	m
ruddy	m
rudi	m
rudie	m
rudiger	m
rudo	m
rudolf	m
rudolfo	m
rudolph	m
rudy	m
rudyard	m
rufe	m
rufina	w
rufino	m
rufus	m
ruggero	m
ruggiero	m
rukus	m
rulza	w
rumbo	m
rumer	w
rumina	w
runa	w
rune	m
rupert	m
ruperta	w
ruperto	m
ruppert	m
ruprecht	m
rurik	m
rusa	w
ruskin	m
ruslan	m
rusna	w
russ	m
russell	m
rustie	m
rustin	m
rusty	m
rut	w
rutger	m
ruth	w
ruthann	w
ruthanne	w
ruthe	w
rutherford	m
ruthi	w
ruthie	w
ruthild	w
ruthy	w
rutledge	m
rutter	m
ruttger	m
ruy	m
ryan	m
ryann	w
ryanne	w
ryba	w
rycca	w
ryder	m
ryke	m
rylan	m
rylee	b
ryleigh	w
ryley	m
rylie	w
ryo	m
ryon	m
ryska	w
ryszard	m
ryun	m
régine	w
rína	w
rítsa	w
rüdiger	m
sa'adeddin	m
saadettin	m
saara	w
saba	w
saban	m
sabeth	w
sabia	w
sabina	w
sabine	w
sabino	m
sabiny	w
sabirah	w
sabra	w
sabri	m
sabrina	w
saburo	m
sacha	b
sachiel	m
sada	w
sade	w
sadella	w
sadettin	m
sadie	w
sadira	w
sadye	w
saffi	w
safiya	w
sagara	w
sage	b
sagiv	m
sahin	m
sahra	w
sahsha	w
said	m
saida	w
saidee	w
saige	w
saima	w
saki	w
sakima	m
sakinah	w
sakura	w
sal	b
saladin	m
salaidh	w
salathiel	m
salea	w
saleem	m
salem	m
salih	m
salim	m
salimah	w
salina	w
salix	m
salka	w
sallee	w
salli	w
sallie	w
sally	w
sallyann	w
sallyanne	w
salma	w
salman	m
salme	w
salmon	m
saloma	w
saloman	m
salome	w
salomi	w
salomo	m
salomon	m
salomone	m
salvador	m
salvatore	m
salvatrice	w
salvidor	m
salvina	w
sam	b
samantha	w
samara	w
samaria	w
samarina	w
sami	m
samia	w
samicah	w
samir	m
samira	w
sammie	m
sammy	b
sampo	m
sampsa	m
sampson	m
samson	m
samu	m
samuel	m
samuela	w
samuele	m
samuli	m
samy	m
sanaya	w
sancho	m
sancia	w
sande	w
sander	m
sanders	m
sanderson	m
sandi	w
sandia	w
sandie	w
sandon	m
sandor	m
sandra	w
sandrina	w
sandrine	w
sandro	m
sandy	b
sandya	w
sandye	w
sanford	m
sanja	w
sanna	w
sanne	w
sanni	w
sanson	m
sansone	m
santa	w
santeri	m
santhosh	m
santiago	m
santino	m
santo	m
santos	m
santuzza	w
sanura	w
sanuye	w
sanya	b
saphira	w
sapozhnika	w
sapphira	w
sapphire	w
sara	w
sara-ann	w
sara-lena	w
saraann	w
sarah	w
sarahi	w
sarai	w
saraid	w
sarajane	w
sarauniya	w
sarbis	m
sarea	w
saree	w
sarena	w
sarene	w
sarette	w
sarge	m
sargent	m
sari	w
saria	w
sarina	w
sarine	w
sarisha	w
sarita	w
sarjo	m
sarvapalli	m
sascha	b
sasha	b
sashah	w
sashana	w
sashenka	w
sashia	w
sashka	w
saskia	w
sasso	m
satan	m
satinka	w
sato	w
satoshi	m
satu	w
saturnina	w
saturnino	m
saturnus	m
saudra	w
saul	m
saulus	m
sauncho	m
saunder	m
saunders	m
saunderson	m
saundra	b
sausha	w
sauveur	m
savana	w
savanna	w
savastian	w
savastianova	w
saveria	w
saverio	m
savina	w
savino	m
savio	m
savína	w
saw	m
sawyer	m
sawyere	m
sax	m
saxe	m
saxon	m
say	m
sayer	m
sayers	m
sayo	w
sayre	b
sayres	m
sbyslava	w
scarface	m
scarlet	w
scarlett	w
scevola	m
schuyler	m
schwanhild	w
scilla	w
scipio	m
scot	m
scott	m
scotti	m
scottie	m
scotty	m
seamus	m
sean	b
seana	w
seanna	w
season	w
sebaldus	m
sebasten	w
sebastian	m
sebastiana	w
sebastiano	m
sebastien	m
seda	w
sedania	w
sedat	m
see	m
seema	w
sefa	w
seff	m
seif	m
seija	w
seka	w
sekundus	m
sela	w
selah	w
selahattin	m
selby	m
selen	w
selena	w
selene	w
selestina	w
selia	w
selianka	w
selie	w
selig	m
selim	m
selima	w
selin	w
selina	w
selinda	w
selinde	w
seline	w
selivankov	w
selivankova	w
sella	w
selle	w
selma	w
selman	m
selvaggia	w
selína	w
selíni	w
sem	m
sema	w
semaj	m
semenova	w
semenovskaia	w
semih	m
semino	m
semislava	w
semjon	m
semra	w
semyon	m
sena	w
seneb	m
seneca	m
senia	w
senka	w
senna	w
senne	m
senny	w
senol	m
senon	m
senta	w
seonaid	w
sephira	w
sephora	w
sepp	m
seppo	m
sequana	w
serafima	w
serafin	m
serafina	w
serafine	w
serafino	m
serafím	m
seraina	w
seraphim	m
seraphina	w
seraphine	w
serdal	m
serdar	m
serena	w
serene	w
serenity	w
serenus	m
serge	m
sergeant	m
sergei	m
sergej	m
sergent	m
sergio	m
serguei	m
serilda	w
seriozha	m
seriozhenka	m
serpil	w
servatius	m
sesha	w
sesto	m
setana	w
seth	m
settimio	m
seumas	m
sevastian	m
sevastianiia	w
sevastiiana	w
severiano	m
severin	m
severina	w
severino	m
severo	m
sevilay	w
sevim	w
seward	m
seymour	m
seçkin	m
sfandra	w
shada	w
shadia	w
shadow	m
shadrach	m
shae	b
shailendra	m
shaina	w
shaine	b
shakir	m
shakira	w
shalna	w
shalne	w
shalom	b
shamar	m
shamgar	m
shammara	w
shamus	m
shana	w
shanahan	m
shanan	m
shanata	w
shanda	w
shandee	w
shandeigh	w
shandie	w
shandra	w
shandy	b
shane	b
shanessa	w
shani	w
shania	w
shanie	w
shaniya	w
shanley	w
shanna	w
shannah	w
shannan	m
shannen	w
shannon	b
shanon	w
shanta	w
shantala	w
shantay	w
shantee	w
shara	w
sharai	w
shari	w
sharia	w
sharif	m
sharity	w
sharka	w
sharl	w
sharla	w
sharleen	w
sharlene	w
sharline	w
sharman	w
sharon	w
sharona	w
sharron	w
sharyl	w
shasha	w
shashenka	m
shaughn	m
shaun	b
shauna	w
shaw	m
shawn	b
shawna	w
shawnee	w
shawnnessy	w
shay	b
shayla	w
shaylah	w
shaylee	w
shaylyn	w
shaylynn	w
shayna	w
shayne	b
shcastna	w
shchastna	w
shea	b
shealtiel	m
sheba	b
shedema	w
shedra	w
sheela	w
sheelagh	w
sheelah	w
sheena	w
sheeree	w
sheff	m
sheffie	m
sheffield	m
sheffy	m
sheila	w
sheila-kathryn	w
sheilah	w
sheilakathryn	w
shel	w
shela	w
shelagh	w
shelba	w
shelbi	w
shelby	b
shelden	m
sheldon	m
shelia	w
shell	b
shelley	b
shelli	w
shellie	w
shelly	w
shellysheldon	m
shelomo	m
shelovlevaya	w
shelton	m
shem	m
shemar	m
shemer	m
shen	m
shena	w
shep	m
shepard	m
shepherd	m
sheppard	m
shepperd	m
sher	w
shera	w
sherah	w
sheree	w
sheri	w
sheridan	m
sheridon	m
sherie	w
sherill	w
sherilyn	w
sherline	w
sherlock	m
sherlocke	m
sherm	m
sherman	m
shermie	m
shermy	m
sherri	w
sherrie	w
sherry	w
sherwin	m
sherwood	m
sherwynd	m
sherye	w
sheryl	w
sheryn	w
sheyla	w
shigeru	m
shika	w
shimon	m
shina	w
shinoda	w
shiphrah	w
shir	w
shira	w
shiriaeva	w
shirin	w
shirl	w
shirlee	w
shirleen	w
shirlene	w
shirley	w
shirline	w
shirlyn	w
shiro	m
shizu	w
shkonka	w
shobi	w
sholom	m
shomera	w
shona	w
shoshana	w
shoshanna	w
shreya	w
shula	w
shulamith	m
shulammite	w
shun	m
shura	b
shurik	m
shurlock	m
shurlocke	m
shurochka	m
shurwood	m
shushanika	w
shvakova	w
shyanne	w
shylah	w
si	m
siade	w
siana	w
sianna	w
sib	w
sibbie	w
sibby	w
sibeal	w
sibel	w
sibella	w
sibelle	w
sibilla	w
sibille	w
sibley	w
sibyl	b
sibylla	w
sibylle	w
sid	m
sidhe	m
sidnee	m
sidney	b
sidoney	w
sidonia	w
sidonius	m
sidonnie	w
sidorova	w
sidra	w
sidéris	m
siegbert	m
siegfried	m
sieghard	m
sieglinde	w
siegmar	m
siegmund	m
siegram	m
siegrid	w
siegried	w
siegrun	w
siegward	m
sienna	w
sierk	m
sierra	w
sievert	m
siffre	m
sig	m
sigfrid	m
sigfried	m
sigi	m
sigismond	m
sigismondo	m
sigismund	m
sigismundo	m
siglinde	w
sigmar	m
sigmund	m
signe	w
sigourney	w
sigrid	w
sigrun	w
sigurd	m
sigvard	m
sihu	w
siiri	w
sikko	m
siko	w
sila	w
silas	m
sile	w
sileas	w
silesius	m
silja	w
silke	w
silna	w
silva	w
silvain	m
silvan	m
silvana	w
silvano	m
silvanus	m
silvester	m
silvestra	w
silvestro	m
silvetta	w
silvia	w
silviana	w
silvie	w
silvio	m
silvius	m
sim	m
sima	b
simba	w
simeon	m
simeón	m
simmonds	m
simo	m
simodo	m
simon	m
simona	w
simone	w
simonetta	w
simonette	w
simonne	w
simplicius	m
simson	m
siméla	w
sina	w
sinah	w
sinaida	w
sinan	m
sincere	m
sinclair	m
sinclare	m
sindar	m
sindbad	m
sindee	w
sinead	w
sinem	w
singa	w
sini	w
sinikka	w
sinja	w
sinklitikiia	w
sinon	m
sintram	m
siny	w
siobhan	w
siona	w
sioux	w
siouxie	w
sipo	m
sira	w
siran	w
siranjya	w
sirena	w
sireno	m
sirikit	w
sirimavo	m
sirius	m
sirje	w
sirka	w
sirkka	w
sirkku	w
siroun	w
sirpa	w
sisely	w
sisile	w
sissie	w
sissy	w
sisyphus	m
sita	w
sitara	w
siuiunbek	w
siuiunbeka	w
siuiunbuka	w
siunbek	w
siunbeka	w
siusan	w
siv	w
sivan	m
sive	w
sivney	m
siw	b
siward	m
sixten	m
sixtus	m
skadi	w
skamander	m
skameikina	w
skell	m
skelly	m
skip	m
skipp	m
skipper	m
skippie	m
skippy	m
skipton	m
skonka	w
sky	b
skye	b
skyla	w
skylar	b
skyler	m
skylla	w
slade	m
sladjana	w
slany	w
slava	w
slavica	w
slavik	m
slavko	m
slavna	w
slawomir	m
slevin	m
sloan	m
sloane	m
slobodan	m
sly	m
smilla	w
smils	w
smina	w
smirenka	w
smith	m
smitty	m
snanduliia	w
snigurka	w
snoopy	m
sobina	w
sofeia	w
sofia	w
sofie	w
sofiia	w
sofiya	w
sofronio	m
sofía	w
sokrates	m
sokrátis	m
sol	m
solana	w
solange	w
solita	w
sollie	m
solly	m
solomon	m
solveig	w
solène	w
somerset	m
son	m
sonaya	w
sondra	w
sonechka	w
songan	m
songuel	m
songül	w
sonia	w
sonja	w
sonni	w
sonnie	b
sonnnie	w
sonny	b
sontje	w
sonya	w
sonyuru	w
sonyusha	w
sonyushka	w
sophey	w
sophi	w
sophia	w
sophie	w
sophinette	w
sophokles	m
sophoklis	m
sophronia	w
soraya	w
sorcha	w
sorin	m
sorka	w
sorley	m
soroka	w
sosanna	w
sosfena	w
sosipatra	w
soterios	m
sotiroúla	w
sotiría	w
sotírios	m
sotíris	m
soultána	w
soúla	w
soúlis	m
spalding	m
spasenieva	w
spela	w
spence	m
spencer	m
spense	m
spenser	m
spera	w
spica	w
spike	m
spitoslava	w
spitsislava	w
spyrídon	m
spýros	m
squire	m
stace	w
stacee	b
stacey	w
stachus	m
staci	w
stacia	w
stacie	w
stacy	b
stafani	w
staffard	m
stafford	m
staford	m
stamatía	w
stamátis	m
stan	m
stana	w
standford	m
stanfield	m
stanford	m
stanislas	m
stanislaus	m
stanislav	m
stanislava	w
stanislaw	m
stanislov	m
stanka	w
stanleigh	m
stanley	m
stanly	m
stanton	m
stanwood	m
star	w
starla	w
starlene	w
starlin	w
starr	w
starsha	w
stasio	m
stasy	w
stasya	w
stavro	m
stavros	m
stavroula	w
stavroúla	w
stearn	m
stearne	m
stefa	w
stefan	m
stefani	w
stefania	w
stefanida	w
stefanidka	w
stefanie	w
stefano	m
stefanova	w
stefanya	w
steffane	w
steffen	m
steffen-claudio	m
steffi	w
steffie	w
stella	w
sten	m
stepan	m
stepanida	w
stepanova	w
stepha	w
stephan	m
stephana	w
stephani	w
stephania	w
stephanie	w
stephannie	w
stephanus	m
stephen	m
stephenie	w
stephi	w
stephie	w
stephine	w
stephon	m
stepka	b
stergianí	w
sterling	m
stern	m
sterne	m
stesha	w
stevana	w
steve	m
steven	m
stevena	w
stevie	m
stevy	m
steward	m
stewart	m
stian	m
stig	m
stijn	m
stilla	w
stillman	m
stillmann	m
stina	w
stine	w
stinky	m
stirling	m
stjepan	m
stoddard	w
stoke	m
stolma	w
stolpolcha	w
stone	m
stopolcha	w
storko	m
storm	w
stormi	w
stormie	w
stormy	w
stoyan	m
stranizlava	w
stratka	w
strezhena	w
strezhislava	w
strezislava	w
strom	m
strátis	m
stu	m
stuart	m
sture	m
stylianí	w
stylianós	m
stása	w
státhis	m
stávros	m
stéfane	m
stéfanos	m
stélios	m
stélla	w
stéphane	m
stéphanie	w
su	w
sude	w
sudehna	w
sudekhna	w
sudi	m
sudila	w
sue	w
suellen	w
sukey	w
suki	w
sula	w
sulaiman	m
sulamith	w
suleika	w
sulislava	w
sullivan	m
sully	m
sulo	m
sumi	w
summer	w
sumner	m
sumorokova	w
suna	w
sundara	w
sunhild	w
sunklitikiia	w
sunny	b
sunshine	w
surya	w
susa	w
susan	w
susana	w
susanetta	w
susann	w
susanna	w
susannah	w
susanne	w
suse	w
susetta	w
susette	w
susi	w
susie	w
susumu	m
susy	w
sutherlan	m
sutherland	m
sutton	m
suzana	w
suzane	w
suzann	w
suzanna	w
suzanne	w
suzette	w
suzi	w
suzie	w
suzu	w
suzy	w
svakhna	w
svantje	w
svatata	w
svatava	w
svatochna	w
svatohna	w
svea	w
sveisla	w
sven	m
sven-christian	m
sven-martin	m
svend	m
svenja	w
sveta	w
svetlana	w
svetocha	w
svetokhna	w
sveva	w
sviatata	w
sviatokhna	w
sviatoslava	w
svoda	w
swachnina	w
swana	w
swanhild	w
swantje	w
swatawa	w
sweeney	m
swen	m
swenja	w
swetlana	w
syama	w
sybil	w
sybila	w
sybilla	w
sybille	w
sybyl	w
syd	m
sydel	w
sydelle	w
sydnee	w
sydney	b
sydnie	w
syed	m
syeira	w
sylas	m
sylke	w
sylvain	m
sylvan	m
sylvana	w
sylvester	m
sylvia	w
sylviane	w
sylvie	w
sylvio	m
sylwia	w
syman	m
symislava	w
symon	m
syna	w
synan	m
syntyche	w
syp	w
sypovaia	w
syrina	w
sákis	m
sávas	m
sébastien	m
sébastienne	w
séverin	m
séverine	w
sía	w
sílas	m
símos	m
sönke	m
sönnich	m
sören	m
sükrü	m
süleyman	m
taavi	m
tab	m
taban	m
tabari	m
tabatha	w
tabb	m
tabbatha	w
tabbi	w
tabbie	b
tabbitha	w
tabby	b
tabea	w
taber	m
tabina	w
tabita	w
tabitha	w
tabor	m
tacha	w
tachia	w
tachiana	w
tachianna	w
tacita	w
tacito	m
tacitus	m
tad	m
tadao	m
tadashi	m
tadd	m
taddeo	m
taddeusz	m
tadeas	m
tadeo	m
tades	m
tadeusz	m
tadi	b
tadio	m
taffy	w
tagino	m
taha	m
tahir	m
tahira	w
tahn	w
tahna	w
tahnia	w
tahniya	w
tahnya	w
tahsha	w
tahvo	m
taidula	w
tailor	m
taima	w
taina	w
tainja	w
taisha	w
taishineia	w
taisiia	w
taisto	m
tait	m
taite	m
tajo	m
taka	w
takara	w
takenya	w
takis	m
takiyah	w
takoda	w
takumi	m
tala	w
talbert	m
talbot	m
talea	w
talesia	w
taletta	w
talia	w
talida	w
talina	w
talitha	w
taliyah	w
tallia	w
tallie	b
tallou	w
tallulah	w
tally	b
talman	m
talon	m
talos	m
talya	w
talyah	w
tam	m
tama	w
tamaki	w
tamar	w
tamara	w
tamarah	w
tamarra	w
tamary	w
tamas	m
tamera	w
tami	w
tamia	w
tamika	w
tamiko	w
tamila	w
tamina	w
tamino	m
tamira	w
tamma	w
tammara	w
tammaro	m
tammaya	w
tamme	m
tammes	m
tammi	w
tammie	b
tammo	m
tammy	b
tamqrah	w
tamra	w
tamryn	b
tamuk	m
tamyra	w
tan	m
tana	w
tanaka	w
tanalia	w
tanasha	w
tanaya	w
tancredo	m
tandi	w
tandie	w
tandula	w
tandy	w
tanea	w
tanechka	w
taneya	w
tanhya	w
tani	b
tania	w
tanija	w
taniqua	w
tanisha	w
tanita	w
tanitansy	w
taniya	w
tanja	w
tanka	w
tankred	m
tann	m
tanna	w
tanner	m
tanney	m
tannia	w
tannie	m
tannis	w
tanniya	w
tanny	m
tannya	w
tano	m
tansy	b
tantalus	m
tanya	w
tapani	m
tapio	m
tara	w
tarah	w
tarak	m
taranis	m
tarasios	m
tarek	m
tarik	m
tariq	m
tarja	w
taro	m
tarquin	m
tarra	w
tarrah	w
tarrance	m
taru	w
taruna	w
taryn	w
tarzan	m
taschja	w
tasenka	w
tasha	b
tashana	w
tashia	w
tashiana	w
tashianna	w
tashina	w
tashira	w
tashiya	w
tasia	w
tasida	b
tasmina	w
tassa	w
tassilo	m
tasya	w
tasía	w
tata	w
tate	b
tatiana	w
tatiania	w
tatianka	w
tatianna	w
tatiiana	w
tatiána	w
tatjana	w
tatsa	w
tatum	w
tatyana	w
taunia	w
taunya	w
taurin	m
taviah	w
tavion	m
tavlunbeka	w
tawia	w
tawnia	w
tawny	w
tawnya	w
tawsha	w
taxiárchis	m
taya	w
tayce	w
tayfun	m
taylan	m
tayler	m
taylor	m
tayna	w
tazia	w
teador	m
teagan	w
tecla	w
ted	b
tedd	m
tedda	w
teddi	w
teddie	b
teddy	b
tedi	w
tedie	m
tedman	m
tedmund	m
tedra	w
teemu	m
teena	w
teesha	w
teetje	w
teha	w
tehya	w
teija	w
teirtza	w
tekh	w
tekha	w
tekla	w
tekmessa	w
tekusa	w
tellervo	w
telsa	w
telse	w
tem	m
tema	w
teman	m
temani	m
temina	w
temira	w
temp	m
temple	m
templeton	m
tennessee	m
teo	m
teobaldo	m
teodoor	m
teodor	m
teodora	w
teodorico	m
teodoro	m
teodosio	m
teofil	m
teofila	w
teofilo	m
tera	w
terach	m
terah	m
terence	m
terencia	w
terencio	m
terenzio	m
teresa	w
terese	w
teresina	w
teresita	w
teressa	w
terhenetar	w
terho	m
teri	w
teriann	w
terka	w
terra	w
terrance	m
terrel	m
terrell	m
terrence	m
terri	b
terri-jo	w
terrie	w
terrijo	w
terril	m
terrill	m
terry	b
terrye	w
tersina	w
tertia	w
terttu	w
tertullian	m
terza	w
terzo	m
tesheia	w
teshka	w
tesia	w
tess	w
tessa	w
tessi	w
tessie	w
tessika	w
tessy	w
tetka	w
teukros	m
teutates	m
teuvo	m
tevkel	w
texoma	w
tezz	w
tferianka	w
thabea	w
thacher	m
thaddeus	m
thaddus	m
thaddäus	m
thadea	w
thadeus	m
thadine	w
thain	m
thaine	m
thais	w
thalassa	w
thalea	w
thales	m
thalia	w
thalya	w
thalís	m
thaman	m
than	m
thana	w
thananákis	m
thanasoúla	w
thanasía	w
thanatos	m
thane	m
thanos	m
thanásis	m
thanássis	m
thasha	w
thatch	m
thatcher	m
thaxter	m
thayne	m
thea	w
theadora	w
theanó	w
thebault	m
theda	w
thedric	m
thedrick	m
theia	w
thekla	w
thelma	w
thelsa	w
themistokles	m
themistoklís	m
thenia	w
theo	b
theobald	m
theocháris	m
theodor	m
theodora	w
theodore	b
theodoric	m
theodoros	m
theodosia	w
theodul	m
theodóra	w
theofánis	m
theone	w
theophil	m
theophila	w
theophilus	m
theopoúla	w
thera	w
theres	w
theresa	w
therese	w
theresia	w
theresina	w
theresita	w
theressa	w
therine	w
theron	m
thessalos	m
theódoros	m
theófanos	m
theófilos	m
theófrastos	m
thia	w
thibaud	m
thibaut	m
thierry	m
thies	m
thijs	m
thila	w
thilo	m
thimorn	m
thion	m
thirza	w
thisbe	w
thisdan	m
thoas	m
thodorís	m
thodorós	m
thom	m
thoma	m
thomas	m
thomasa	w
thomasin	w
thomasina	w
thomasine	w
thommy	m
thomás	m
thor	m
thora	w
thoralf	m
thorben	m
thorbjörn	m
thore	m
thorin	m
thorn	m
thorndike	m
thornie	m
thornton	m
thorny	m
thorpe	m
thorstein	m
thorsten	m
thorvald	m
thorwald	m
thrasývoulos	m
thure	m
thurstan	m
thurston	m
thusita	w
thusnelda	w
thyra	w
thyria	w
thános	m
thékla	w
thémis	m
théo	m
théo(s)	m
théodore	m
thérèse	w
thímios	m
thódoras	m
tia	w
tiada	w
tiaga	w
tiago	m
tiana	w
tianna	w
tiara	w
tibalt	m
tibbot	m
tiberia	w
tiberius	m
tibeta	w
tibold	m
tibor	m
tibot	m
tiebold	m
tiebout	m
tiena	w
tienette	w
tiernan	m
tierney	w
tierra	w
tiertza	w
tiff	w
tiffani	w
tiffanie	w
tiffany	w
tiffi	w
tiffie	w
tiffney	w
tiffy	w
tigest	w
tigo	m
tigran	m
tiia	w
tijana	w
tiktu	m
til	m
tilda	w
tilde	w
tildi	w
tildie	w
tildy	w
tiler	m
till	m
tilla	w
tillie	w
tillman	m
tillmann	m
tillo	m
tilly	w
tilman	m
tilmann	m
tilo	m
tim	m
tim-julen	m
tim-robin	m
timandra	w
timeus	m
timi	w
timm	m
timmi	w
timmie	b
timmy	b
timo	m
timofei	m
timoleon	m
timon	m
timona	w
timoteo	m
timothea	w
timothee	m
timotheus	m
timothy	m
timothée	m
timur	m
timuçin	m
timótheos	m
tina	w
tindra	w
tine	w
tinka	w
tino	m
tinta	w
tinus	m
tiomir	m
tiphani	w
tiphanie	w
tiphany	w
tiponya	w
tiras	m
tirato	m
tirrell	m
tirza	w
tisa	w
tish	w
tisha	w
tishka	w
tishkina	w
tita	w
titania	w
titianus	m
titina	w
titka	w
tito	m
titos	m
titus	m
tiutcheva	w
tivedar	m
tivon	m
tivona	w
tizia	w
tizian	m
tiziana	w
tiziano	m
tjalda	w
tjalf	m
tjark	m
tjorven	w
toal	m
tobe	b
tobey	w
tobi	b
tobiah	m
tobias	m
tobie	m
tobin	m
tobit	m
toby	b
tobye	w
tod	m
todd	m
toddie	m
toddy	m
tohon	m
toiboid	m
toinette	w
toivo	m
tola	w
tolenka	m
tolman	m
tolommeo	m
tolya	m
tom	m
tom-tassilo	m
tom-thorben	m
toma	w
tomas	m
tomasin	w
tomasina	w
tomasine	w
tomaso	m
tomasz	m
tome	m
tomi	w
tomila	w
tomislav	m
tomislava	w
tomkin	m
tomlin	m
tomma	w
tommaso	m
tommie	b
tommy	b
tomo	w
tonasha	w
tonaya	w
tonechka	w
toni	b
tonia	w
tonie	w
tonio	m
tonja	w
tonnie	m
tonniya	w
tonnya	w
tony	b
tonya	w
tonye	w
tooske	w
tootsie	w
topi	m
toprak	m
topsy	w
tora	w
toralf	m
torben	m
tord	m
tore	m
torey	b
torfinn	m
torge	m
tori	w
torie	w
torin	m
torokanova	w
torr	m
torrance	m
torre	m
torrence	m
torrey	m
torrie	w
torrin	m
torry	m
torsten	m
torvon	m
tory	w
tosca	w
toshiana	w
tosia	w
tosya	m
tova	w
tove	w
tovi	m
town	m
towney	m
townie	m
townsend	m
towny	m
tozzo	m
trace	m
tracee	w
tracey	b
traci	w
tracie	b
tracy	b
traianós	m
traude	w
traudel	w
traudl	w
traugott	m
traute	w
traver	m
travers	m
travin	m
travis	m
travon	m
travus	m
treasa	w
trefor	m
tremain	m
tremaine	m
tremayne	m
trenna	w
trent	m
trenton	m
tresa	w
trescha	w
tressa	w
tretiakovskaia	w
trev	m
treva	w
trevar	m
trever	m
trevin	m
trevion	m
trevon	m
trevor	m
trey	m
treyton	m
triandáfilos	m
triantafylliá	w
tricia	w
trilby	w
trina	w
trinity	w
trip	m
tripp	m
tris	m
trish	w
trisha	w
trista	w
tristam	m
tristan	m
tristian	m
tristin	m
triston	m
trix	w
trixi	w
trixie	w
trixy	w
troika	w
troy	m
trpena	w
trstram	m
truda	w
trude	w
trudel	w
trudey	w
trudi	w
trudie	w
trudy	w
trueman	m
trufena	w
trula	w
trumaine	m
truman	m
trumann	m
trutz	m
tryne	w
tryphena	w
tryphosa	w
trystan	m
tsambika	w
tsaritsa	w
tsvetkova	w
tuana	w
tuathal	m
tuck	m
tucker	m
tuckie	m
tucky	m
tudor	m
tuesday	w
tuija	w
tuire	w
tuketu	m
tula	w
tull	m
tulla	w
tulley	m
tullia	w
tullio	m
tully	b
tulna	w
tuncay	m
tunde	w
tunu	m
tunç	m
tuomas	m
turner	m
tusa	w
tusya	m
tutana	w
tuula	w
tuuli	w
tuulikki	w
tuva	w
tuvya	m
tuwa	w
tvoislava	w
tvoyzlava	w
twila	w
twyla	w
ty	m
tybalt	m
tybi	w
tybie	w
tyche	w
tycho	m
tychó	w
tye	m
tyee	m
tyler	m
tylor	m
tymon	m
tymothy	m
tynan	m
tyne	w
tyra	w
tyree	m
tyrell	m
tyrese	m
tyrone	m
tyrus	m
tyshawn	m
tyson	m
tyyne	w
tyyni	w
tyytti	w
tzuriel	m
tákis	m
tásos	m
télis	m
téssa	w
tía	w
tíga	w
tímon	m
tímos	m
tólia	w
tólis	m
tóni	m
tónia	w
tónis	m
tülay	w
tünde	w
türkan	w
türker	m
ualan	m
ualentina	w
uathne	w
uba	b
ubadah	b
ubaid	m
ubald	m
ubbo	m
ubena	w
ubene	w
uberto	m
ubul	m
uda	w
udale	m
udall	m
udeh	m
udele	w
udell	m
udith	w
udo	m
udolf	m
ueli	m
ufuk	m
ugdalf	m
ugdan	m
ugo	m
ugolino	m
ugor	m
ugur	m
uilleag	m
uilleam	m
uilliam	m
uinseann	m
uirko	w
uisdean	m
uistean	m
ukko	m
ula	w
ulan	m
ulana	w
uland	m
ulani	b
ulberto	m
ulbrecht	m
uldarico	m
uleia	w
ulen'ka	w
ulf	m
ulfert	m
ulfried	m
uli	b
ulia	w
uliaanitsa	w
uliana	w
ulianiia	w
ulianka	w
ulianushka	w
uliasha	w
ulick	m
uliiana	w
ulima	w
ulises	m
ulissa	w
ulisse	m
ulita	w
ulixes	m
uljana	w
ulla	w
ulle	w
ulli	b
ullrich	m
ulmann	m
ulprus	m
ulric	m
ulrica	w
ulrich	m
ulrick	m
ulrik	m
ulrika	w
ulrikaumeko	w
ulrike	w
ulrique	w
ultan	m
ultima	w
ultman	m
ultreia	w
ulucan	m
ululani	w
ulva	w
ulvi	m
ulviye	w
ulyana	w
ulyssa	w
ulysses	m
uma	w
umai	w
umar	m
umberto	m
ume	w
umeko	w
umit	m
umut	m
una	w
unai	m
unaiza	w
undine	w
unefiia	w
uner	m
unice	w
unique	w
unity	w
unka	w
unna	w
unnati	w
unni	b
untamo	m
unto	m
unwin	m
uolevi	m
uoti	m
upor	m
upritsa	w
upshaw	m
upton	m
urania	w
urbain	m
urban	m
urbana	w
urbano	m
urbanus	m
urda	w
urho	m
uri	m
uria	w
uriah	m
urian	m
uriana	w
urias	m
urie	m
uriel	m
urien	m
urit	w
urjavah	m
urmila	w
urmina	w
uros	m
urpo	m
urras	m
urs	m
ursa	w
ursala	w
ursanne	w
ursel	w
ursella	w
urshila	w
ursina	w
urska	w
ursola	w
urson	m
ursula	w
ursule	w
ursulina	w
ursuline	w
ursus	m
urszula	w
urte	w
urvasi	w
usagi	w
usamah	m
uschi	w
usha	w
ushi	w
ushma	w
usim	m
usko	m
usoa	w
ustenia	w
ustin	m
ustiniia	w
ustinya	w
uta	w
ute	w
uthman	m
utina	w
utt	m
utta	w
uttam	m
uttara	w
utz	m
uwain	m
uwe	m
uxia	w
uxio	m
uzi	m
uzma	w
uzoma	b
uzor	m
uzziah	m
uzziel	m
vacarro	m
vachel	m
vaclav	m
vada	w
vadim	m
vadin	m
vahan	m
vahdet	m
vail	m
vaira	w
vakhneva	w
vakhtina	w
val	b
vala	w
valantís	m
valaree	w
valaria	w
valarie	w
valary	w
valda	w
valdemar	m
valdis	w
vale	b
valea	w
valeda	w
valencia	w
valene	w
valenka	w
valenta	w
valentia	w
valentijn	m
valentin	m
valentina	w
valentine	b
valentino	m
valentiní	w
valentína	w
valentíno	m
valentínos	m
valentíon	m
valera	w
valeri	b
valeria	w
valerian	m
valeriana	w
valeriane	w
valerianós	m
valerie	w
valerii	m
valerij	m
valerik	m
valerio	m
valerius	m
valeriya	w
valeriána	w
valery	b
valerye	w
valerís	m
valesca	w
valeska	w
vali	m
valia	w
valida	w
valina	w
valkyrie	w
valle	m
valli	w
vallie	w
vally	w
valma	w
valonia	w
valora	w
valorie	w
valpas	m
valpo	m
valpuri	w
valry	w
valter	m
valto	m
valtteri	m
valya	w
valándis	m
valántios	m
valère	m
valéria	w
valérie	w
valérios	m
van	b
vana	w
vanadis	w
vanamo	w
vance	m
vanda	w
vanechka	m
vanesa	w
vanessa	w
vangelis	m
vangelió	w
vangélis	m
vania	w
vanida	w
vanilla	w
vanja	w
vanmra	w
vanna	w
vannie	w
vanny	w
vanora	w
vanya	b
vanyusha	m
varda	w
varenka	w
varfolomey	m
varg	m
varinia	w
varinius	m
varinka	w
varius	m
varka	w
varlam	m
varnava	m
varney	m
varnávas	m
varsonofia	w
vartan	m
vartholoméos	m
vartouhi	w
vartsislava	w
varushka	w
varvara	w
varvaroúla	w
varvarítsa	w
varvára	w
varya	w
varyusha	w
vas	m
vasant	m
vasanta	w
vasco	m
vashti	w
vasil	m
vasileva	w
vasilevna	w
vasilevskaia	w
vasili	m
vasilica	m
vasilida	w
vasilievaia	w
vasilii	b
vasiliki	w
vasilikoúla	w
vasilikí	w
vasilina	w
vasilios	m
vasilis	m
vasilisa	w
vasilissa	w
vasilista	w
vasilka	w
vasily	m
vasilákis	m
vasilía	w
vasio	m
vasisa	w
vasoúla	w
vassa	w
vassi	m
vassili	m
vassilios	m
vassillissa	w
vassily	m
vasya	b
vasyl	m
vasylyna	w
vasílios	m
vasílis	m
vaughan	m
vaughn	m
vaviia	w
vavrinec	m
veca	w
veda	w
vedastus	m
vedat	m
vedrana	w
veera	w
veeti	m
vefik	m
vega	w
veikko	m
veini	m
veit	m
velda	w
veli	m
velia	w
velika	w
velimir	m
velislava	w
velissários	m
velma	w
velvel	m
velvela	w
velvet	w
vena	w
vencel	m
venceslao	m
venceslav	m
venediktíni	w
veneta	w
venetia	w
venetía	w
veniamin	m
venita	w
venitia	w
venka	w
venkat	m
venla	w
ventseslava	w
venus	w
venyamin	m
venédikti	w
venédiktos	m
venéta	w
vera	w
veradis	w
vercingetorix	m
vere	b
vered	b
verena	w
verene	w
vereníki	w
verge	m
vergil	m
verian	m
veriee	w
verile	w
verina	w
verine	w
verissimo	m
verity	w
verla	w
vern	m
verna	w
verne	m
vernen	m
verner	m
vernessa	w
verney	m
vernice	w
vernier	m
vernon	m
vernor	m
verochka	w
verona	w
veronica	w
veronika	w
veronike	w
veronikeia	w
veronique	w
veroníki	w
veroúla	w
vershina	w
veruschka	w
verína	w
vesa	m
vesile	w
vesna	w
vespasian	m
vespasiano	m
vespasianus	m
vespera	w
vesta	w
vester	m
vetenega	w
veva	w
vevay	w
veveia	w
vevila	w
vi	w
viachenega	w
vianne	w
vibeke	w
vibol	m
vic	b
vica	w
vicente	m
vick	m
vicki	w
vickie	w
vicky	w
vico	m
victoir	m
victoire	w
victor	m
victoria	w
victorin	m
victorine	w
victorino	m
victorius	m
vid	m
vida	w
vidal	m
vidar	m
vidette	w
vidonia	w
vidovic	m
vidovik	m
vidya	w
vienne	w
vieno	w
viggo	m
vijay	m
vijaya	w
vika	w
vikashenka	w
vikenti	m
vikentís	m
viki	w
vikki	w
vikky	w
vikram	m
viktor	m
viktoras	m
viktoria	w
viktoriya	w
viktoría	w
vikéntios	m
vila	w
vilas	m
vilchjo	m
vilem	m
vilen	m
vilena	w
vilenina	w
vilfred	m
vilhelm	m
vilhelmas	m
vilhelmi	m
vilhelmina	w
vilhelmo	m
vilhlems	m
vilho	m
vili	m
viliana	w
viljami	m
viljem	m
viljo	m
vilko	m
ville	m
vilma	w
vilmar	m
vilmos	m
vilna	w
vimal	m
vimala	w
vin	b
vina	w
vinal	m
vinay	m
vince	m
vincenc	m
vincent	m
vincentas	m
vincente	m
vincents	m
vincenty	m
vincenz	m
vincenza	w
vincenzo	m
vinicio	m
vinita	w
vinko	m
vinni	w
vinnie	b
vinny	b
vinod	m
vinson	m
vinzenz	m
viola	w
violante	w
viole	w
violet	w
violetta	w
violette	w
violéta	w
viona	w
viorel	m
viorica	w
viotto	m
vipin	m
vipul	m
virge	m
virgie	b
virgil	m
virgilio	m
virgina	w
virginia	w
virginie	w
virginía	w
viriato	m
viridis	w
virineia	w
vironikiia	w
virág	m
vishal	m
vishemila	w
vishnu	m
visnja	w
visolela	w
vissaríon	m
vissaríonas	m
vistella	w
vita	w
vitale	m
vitali	m
vitalia	w
vitalis	m
vitaliy	m
vitaly	m
vitalya	w
vitario	m
vitasa	w
vite	m
vitenka	m
vithleém	w
vitia	w
vitko	w
vitla	w
vito	m
vitor	m
vitoria	w
vitoslava	w
vittore	m
vittoria	w
vittorino	m
vittorio	m
vitulja	m
vitus	m
vitya	m
viv	w
viva	w
vivek	m
viveka	w
vivi	w
vivia	w
vivian	b
viviana	w
viviane	w
vivianna	w
vivianne	w
viviano	m
vivianí	w
vivica	w
vivie	w
vivien	w
viviene	w
vivienne	w
viviette	w
viviyan	w
viviána	w
vivka	w
vivyan	w
vivyanne	w
vióla	w
vjeko	m
vjekoslav	m
vjekoslava	w
vjollka	w
vlad	m
vlada	w
vladaia	w
vladamir	m
vladik	m
vladilen	m
vladilena	w
vladilenaova	w
vladimir	m
vladimira	w
vladisava	w
vladislav	m
vladislava	w
vladka	w
vladlen	m
vladlena	w
vladmir	m
vladmiri	m
vlado	m
vladya	m
vladímiros	m
vlaho	m
vlaikha	w
vlasis	m
vlasos	m
vlassis	m
vlasta	w
vlastika	w
vlastimil	m
vlastislav	m
vlatko	m
vlcena	w
vlschet	w
vlántis	m
vlásios	m
vlássis	m
vogna	w
voina	w
voirrey	w
voislava	w
voitto	m
vojtech	m
voleta	w
volkan	m
volkard	m
volker	m
volkert	m
volkhard	m
volkmar	m
vollina	w
volmari	m
volodimerna	w
volody	m
volodya	m
volodymyr	m
volos	m
volotka	w
volotkoveia	w
volotok	w
volquin	m
voltan	m
volya	m
von	m
vonda	w
vonni	w
vonnie	w
vonny	w
vorlop	m
vova	m
voyzlava	w
vrasídas	m
vrata	w
vratislava	w
vreneli	w
vreni	w
vrkhuslava	w
vroni	w
vrotsislava	w
vrsanka	w
vseslava	w
vsevolod	m
vuk	m
vukasin	m
vukosava	w
vukoslava	w
vulcan	m
vulkanus	m
vural	m
vyacheslav	m
vyesna	w
vyky	w
vysheslava	w
vyshia	w
vytautas	m
václav	m
václava	w
vágia	w
váios	m
vália	w
válios	m
vásia	w
váso	w
vásos	m
véra	w
véronique	w
víki	w
víktor	m
víktoras	m
víky	w
vívi	w
vívian	w
výron	m
výronas	m
waban	m
waclaw	m
wade	m
wadsworth	m
wafi	m
wafiya	w
waheeda	w
wahid	m
wahida	w
wahnfried	m
waidgund	w
wain	m
wainwright	m
wait	m
waite	m
waiter	m
wakanda	w
wake	m
wakefield	m
wakiza	m
wala	w
walarich	m
walburga	w
wald	m
waldbert	m
waldemar	m
walden	m
walderia	w
waldo	m
waldon	m
waldtraud	w
waldtraut	w
walentina	w
walenty	m
walfried	m
walker	m
wallace	m
wallache	m
wallas	m
walli	w
wallie	b
wallis	b
walliw	w
wally	b
walpora	w
walpurga	w
walsh	m
walt	m
walter	m
walther	m
walton	m
waltraud	w
waltraut	w
waltrud	w
waly	w
wamoda	w
wanda	w
wandeline	w
wandie	w
wandis	w
wandula	w
waneta	w
wang	m
wanids	w
wanko	m
wannon	w
wapasha	m
wapeka	w
wapi	m
ward	m
warde	m
wardell	m
warden	m
ware	m
warenka	w
waring	m
warja	w
warner	m
warren	m
warvara	w
warwara	w
warwick	m
wash	m
washington	m
wasil	m
wasim	m
wasja	m
wassili	m
wassim	m
wasswa	m
wasyl	m
wasylyna	w
wat	m
wava	w
waverley	m
waverly	m
way	m
waylan	m
wayland	m
waylen	m
waylin	m
waylon	m
wayna	w
wayne	m
web	m
webb	m
weber	m
webster	m
weda	w
wedigo	m
weidar	m
weider	m
welbie	m
welby	m
welch	m
weldon	m
welf	m
welislawa	w
wells	m
welsh	m
welty	m
wenceslas	m
wencke	w
wenda	w
wendall	m
wendel	m
wendelin	b
wendeline	w
wendell	m
wendi	w
wendie	w
wendy	w
wendye	w
wenke	w
wenona	w
wenonah	w
wenutu	m
wenzel	m
wenzeslaus	m
wera	w
werner	m
wernher	m
weronika	w
werther	m
wes	m
wesley	m
west	m
westbrook	m
westbrooke	m
westleigh	m
westley	m
weston	m
weylin	m
wheeler	m
whit	m
whitaker	m
whitby	m
whitman	m
whitney	b
whittaker	m
whoopy	w
whylma	w
wiatt	m
wibeke	w
wibke	w
wiborada	w
wickaninnish	m
wiclif	m
widad	w
wiebe	m
wiebke	w
wieland	m
wielislaw	m
wierga	w
wieslaw	m
wieslawa	w
wigand	m
wigbert	m
wigburg	w
wikolia	w
wiktor	m
wiktoria	w
wil	m
wilbert	m
wilbur	m
wilburn	m
wilburt	m
wilda	w
wilden	m
wildon	m
wileen	w
wilek	m
wiley	m
wilf	m
wilford	m
wilfred	m
wilfreda	w
wilfredo	m
wilfrid	m
wilfrido	m
wilfried	m
wilfrieda	w
wilfriede	w
wilhelm	m
wilhelma	w
wilhelmina	w
wilhelmine	w
wilie	w
wilja	w
wilkie	m
wilko	m
will	m
willa	w
willabella	w
willamina	w
willard	m
willdon	m
willem	m
willetta	w
willette	w
willey	m
willfried	m
willhart	m
willi	m
william	m
willibald	m
willibert	m
willie	b
willis	m
willoughby	m
willow	w
willy	b
willyt	w
wilm	m
wilma	w
wilmar	m
wilmer	m
wilmette	w
wilmont	m
wilmot	m
wilmut	m
wilney	m
wilona	w
wilone	w
wilow	w
wilpert	m
wilson	m
wilt	m
wilton	m
wiltrud	w
wilu	m
wim	m
win	m
wina	w
wincenty	m
winda	w
windham	m
windsor	m
windy	w
winema	w
winfield	m
winfred	m
winfried	m
winfrieda	w
wini	w
winifield	m
winifred	w
winimar	m
winn	m
winna	w
winnah	w
winne	w
winnetou	m
winni	w
winnie	b
winnifred	w
winny	b
winola	w
winona	w
winonah	w
winslow	m
winston	m
winter	w
winthrop	m
winton	m
wioletta	w
wira	w
wiremu	m
wisdom	w
wislaw	m
wissa	w
wit	m
witali	m
witiko	m
witold	m
witoslava	w
witta	w
wittie	m
witty	m
wiwka	w
wladimir	m
wladyka	w
wladyslaw	m
wlodek	m
wlodzislaw	m
woden	m
woina	w
wojciech	m
wojtek	m
woldemar	m
wolf	m
wolf-dieter	m
wolf-dietrich	m
wolf-gero	m
wolf-rüdiger	m
wolfdietrich	m
wolfe	m
wolfgang	m
wolfhard	m
wolfie	m
wolfman	m
wolfram	m
wolfy	m
wolodymyr	m
wood	m
woodie	m
woodman	m
woodrow	m
woody	m
worden	m
worth	m
worthington	m
worthy	m
wotan	m
wout	m
wouter	m
wrata	w
wratislava	w
wren	w
wrennie	w
wright	m
wrocislawa	w
wulf	m
wulfhelm	m
wulfram	m
wunand	m
wyanet	w
wyatan	m
wyatt	m
wybert	m
wye	m
wylie	m
wylma	w
wymond	m
wyn	m
wyndham	m
wynfor	m
wynn	b
wynne	b
wynnie	w
wynny	w
wynonna	w
wynono	m
wynter	w
wyomia	w
wystan	m
xabier	m
xafira	w
xan	m
xander	m
xandra	w
xandro	m
xandy	w
xanthe	w
xanthia	w
xanthippe	w
xanthus	m
xanthípi	w
xanti	m
xantippe	w
xao	m
xaquelina	w
xara	w
xaver	m
xaveria	w
xavia	w
xaviar	m
xavier	m
xaviera	w
xavior	m
xeledur	m
xena	w
xene	w
xenia	w
xeno	m
xenobia	w
xenocrates	m
xenofón	m
xenon	m
xenophon	m
xenos	m
xenthia	w
xeran	m
xerane	w
xerber	m
xeres	m
xerxes	m
xesús	m
xever	m
xiang	w
xiao	m
ximen	m
ximena	w
ximenes	m
ximenez	m
ximun	m
xiomara	w
xiu mei	w
xoana	w
xochilt	w
xochipilli	m
xochiquetzal	w
xochitl	w
xolani	m
xosé	m
xurxo	m
xuxa	w
xyleena	w
xylia	w
xylina	w
xylon	m
xylona	w
xymenes	m
xystus	m
xyza	w
xzavier	m
xénia	w
yachin	m
yachna	w
yacin	m
yadid	m
yadiel	m
yadin	m
yadira	w
yadon	m
yael	w
yaffa	w
yagmur	w
yago	m
yahir	m
yahto	m
yahveh	m
yair	m
yakecan	m
yakez	m
yakim	m
yakira	w
yakiv	m
yakov	m
yaksha	w
yale	m
yalena	w
yalenchka	w
yalens	w
yaletha	w
yalonda	w
yaluta	w
yam	w
yamini	w
yamka	w
yamura	w
yan	m
yana	b
yanaba	w
yanamandra	w
yanaton	m
yance	m
yancey	m
yancy	m
yang	w
yanic	m
yanick	m
yanik	m
yanira	w
yanire	w
yanis	m
yank	m
yankee	m
yankel	m
yanko	m
yann	m
yanna	w
yanni	m
yannic	m
yannick	m
yannik	m
yannis	m
yantus	m
yara	w
yaravi	w
yard	m
yardan	m
yarden	m
yardena	w
yardley	m
yaremka	m
yaren	w
yarim	m
yarin	m
yarissa	w
yarkona	w
yarmilla	w
yaromir	m
yaron	m
yaropolk	m
yaroslav	m
yaroslava	w
yarum	m
yasamin	w
yasar	m
yasashiku	m
yasemin	w
yash	m
yasha	m
yashmine	w
yashodhar	m
yashovarman	m
yashpal	m
yashwant	m
yasin	m
yasir	m
yasmeen	w
yasmin	w
yasmina	w
yasmine	w
yasser	m
yassin	b
yasu	w
yasuo	m
yates	m
yavanna	w
yavonna	w
yavuz	m
yayoi	w
yazid	m
yazmin	w
ydel	w
yedda	w
yefim	m
yefrem	m
yegor	m
yehiel	m
yehudah	m
yehudi	m
yehudit	b
yei	w
yejide	w
yekaterina	w
yekta	m
yelena	w
yeliz	w
yelizaveta	w
yelta	w
yelutci	m
yelva	w
yemelyan	m
yemena	w
yemima	w
yemina	w
yemon	m
yendar	m
yenene	w
yener	m
yennifer	w
yente	w
yentl	m
yeoman	m
yeoryia	w
yeoryios	m
yered	m
yerik	m
yermolai	m
yervant	m
yesenia	w
yeshaya	m
yesmina	w
yessenia	w
yessica	w
yestin	m
yeter	m
yeti	m
yeto	m
yetta	w
yettie	w
yetty	w
yeva	w
yevdokiya	w
yevette	w
yevfrosinya	w
yevgeni	m
yevgeniya	w
yevgeny	m
yevgenya	w
yevpraksiya	w
yguerne	w
yianni	m
yiannis	m
yidel	w
yigit	m
yildiz	b
yilmaz	m
yiorgos	m
yitzhak	m
ylenia	w
ylonka	w
ylva	w
ylvi	w
ylvie	w
ylwa	w
ynes	w
ynez	w
yngvar	m
yo	m
yoan	m
yoana	w
yoav	m
yobachi	m
yochanan	m
yoel	m
yogendra	m
yogenya	w
yogesh	m
yogi	m
yogini	w
yogita	w
yohann	m
yoki	w
yoko	w
yola	w
yolanda	w
yolande	w
yolane	w
yolanthe	w
yolde	w
yoline	w
yolonda	w
yomaris	w
yonah	m
yonatan	m
yonca	w
yong	m
yoni	m
yonina	w
yonit	w
yonka	w
yorath	m
yordan	m
yordanka	w
yorge	m
yorgo	m
yorgos	m
yori	m
yorick	m
york	m
yorke	m
yorker	m
yosef	m
yoshi	b
yoshiko	w
yoshio	m
yoshiro	m
yoshiyuki	m
yosif	m
yosyp	m
yotimo	m
younes	m
yovanka	w
yovela	w
yovonnda	w
ypsilándis	m
yrjö	m
yrkia	w
yrsa	w
ysabel	w
ysgarran	m
yu	m
yuan	m
yukako	w
yuki	b
yukiko	b
yukio	m
yul	m
yule	b
yulenka	w
yuli	m
yulia	w
yulian	m
yuliana	w
yulianiya	w
yulika	w
yuliy	w
yuliya	w
yulma	m
yulya	w
yuma	m
yumako	w
yumi	w
yuna	w
yunus	m
yura	m
yuri	m
yuria	w
yurii	m
yurik	m
yurix	m
yuriy	m
yurochka	m
yury	m
yushua	m
yusmara	w
yusra	w
yussel	m
yusuf	m
yusura	w
yutaka	m
yutani	m
yutke	w
yutsuko	w
yuval	m
yvain	m
yven	m
yves	m
yvette	w
yvo	m
yvon	m
yvonne	w
yvor	m
yvora	w
zabel	w
zabela	w
zabia	b
zabrata	w
zabrina	w
zabulon	m
zaccaria	m
zaccheo	m
zach	m
zacharia	m
zachariah	m
zacharias	m
zacharie	m
zachary	m
zacherie	m
zachery	m
zachäus	m
zack	m
zackariah	m
zackary	m
zackery	m
zada	w
zafer	m
zafina	w
zafir	m
zafirah	w
zagger	m
zahara	w
zahavah	w
zahia	w
zahid	m
zahida	w
zahide	w
zahin	m
zahirah	w
zahra	w
zahur	m
zaid	m
zaida	w
zaide	m
zaim	m
zain	m
zaina	w
zainam	m
zaira	w
zaire	m
zajzon	m
zak	m
zakai	m
zakariyya	m
zakary	m
zakharia	w
zakharieva	w
zakharina	w
zaki	m
zakia	w
zakire	w
zala	w
zale	m
zalia	w
zalika	w
zalmai	m
zalman	m
zalmon	m
zalo	m
zaltana	w
zalán	m
zama	w
zambda	w
zambor	m
zamiatina	w
zamir	m
zana	w
zander	m
zandor	m
zandra	w
zane	m
zanebono	m
zaneta	w
zaniel	m
zanipolo	m
zanita	w
zankhana	w
zann	m
zanobi	m
zanthe	w
zaphira	w
zara	w
zarad	m
zarah	w
zaramama	w
zarathustra	m
zaray	w
zared	m
zareen	w
zarek	m
zaria	w
zarifa	w
zarina	w
zarita	w
zaritsa	w
zarjo	m
zarla	w
zarna	w
zasha	w
zavanna	w
zavia	w
zavidovicha	w
zavier	m
zavorokhina	w
zawadi	w
zawati	w
zayden	m
zayit	w
zaylin	w
zayna	w
zayne	m
zazou	w
zazu	m
zbigniew	m
zbina	w
zbinka	w
zbiska	w
zbynek	w
zbynko	w
zbyshka	w
zdena	w
zdenka	w
zdeslava	w
zdislava	w
zdravko	m
zdzislaba	w
zea	w
zeana	w
zeanes	w
zeb	m
zebadiah	m
zebedee	m
zebediah	m
zebedäus	m
zebina	w
zebulen	m
zebulon	m
zebulun	m
zechariah	m
zed	m
zedekiah	m
zee	w
zeeba	w
zeeman	m
zefirino	m
zehava	w
zehra	w
zeitia	w
zeke	m
zeki	m
zelda	w
zelene	w
zelenka	w
zelgai	m
zelia	w
zelig	m
zelimir	m
zelinda	w
zelipe	m
zeljko	m
zella	w
zelma	w
zelpha	w
zemar	m
zemirah	w
zen	m
zena	w
zenaida	w
zenaide	w
zenda	w
zenechka	w
zenia	w
zeno	m
zenoa	m
zenobia	w
zenobio	m
zenochka	w
zenon	m
zenos	m
zenovia	w
zenta	w
zeny	w
zenya	w
zenzi	w
zephan	m
zephaniah	m
zephyr	m
zephyra	w
zephyrin	m
zephyrine	w
zera	w
zerberus	m
zerdali	w
zeren	m
zerind	m
zerk	m
zerlina	w
zerlinda	w
zero	m
zeroun	m
zerrin	w
zeruah	w
zeshawn	m
zesiro	m
zeta	w
zeth	m
zethel	w
zetta	w
zeus	m
zev	m
zeva	w
zevida	w
zeynep	w
zhaja	w
zhalore	w
zhanna	w
zhdana	w
zhen	w
zhena	w
zhenechka	m
zhenya	b
zhirava	w
zhivana	w
zhona	w
zhonka	w
zhorah	m
zia	w
ziahon	w
ziazan	w
ziba	w
zibiah	w
ziff	m
zigana	w
zila	w
zilia	w
zilla	w
zillah	w
zilly	w
zilpah	w
zilvia	w
zilya	w
zima	w
zimra	w
zimraan	m
zimri	m
zina	w
zinaida	w
zinan	m
zinerva	w
zinnia	w
zinovia	w
zinoviia	w
zinoviya	w
zion	m
ziona	w
zippora	w
zirak	m
zisel	w
zita	w
zitella	w
ziv	m
ziva	w
zivana	w
ziven	m
zivit	w
zivon	m
zizi	w
zlata	w
zlatka	w
zlatko	m
zlota	w
znata	w
zobor	m
zoe	w
zoello	m
zoey	w
zofeia	w
zofia	w
zoia	w
zoie	w
zoika	w
zoila	w
zoilo	m
zoja	w
zola	w
zoland	m
zoleen	w
zollie	m
zolly	m
zoltan	m
zona	w
zonda	w
zondan	m
zondra	w
zonnya	w
zora	w
zorah	w
zoraida	w
zoran	m
zorana	w
zorba	m
zordan	m
zorina	w
zorine	w
zorione	w
zoris	m
zorro	m
zory	m
zorzétta	w
zosia	w
zosima	w
zosimo	m
zotia	w
zotico	m
zowie	b
zoya	w
zoyenka	w
zozó	w
zoé	w
zoí	w
zsa-zsa	w
zsa zsa	w
zsazsa	w
zsigmond	m
zsolt	m
ztrezena	w
zula	w
zulaykha	w
zuleika	w
zulema	w
zuri	w
zuriaa	w
zuriel	w
zurl	m
zusa	w
zuza	w
zuzana	w
zuzanny	w
zvatata	w
zvenislava	w
zyanya	w
zygmunt	m
zyriakus	m
zádor	m
zéfs	m
zéta	w
zümra	w
zümrüt	w
ággelos	m
ákis	m
álkis	m
álkisti	w
ándra	w
ángela	w
ángi	w
ánna	w
ánthi	w
ánthimi	w
ánthimos	m
ánti	w
árgiros	m
áris	m
ártemi	w
ártemis	w
áspa	w
äneas	m
änne	w
çagatay	m
çelik	m
édouard	m
éfi	w
élaine	w
éliane	w
émile	m
émilie	w
émilien	m
éros	m
étienne	m
éva	w
évros	m
íra	w
ólga	w
ómiros	m
öcal	m
ödipus	m
ömer	m
örjan	m
öykü	w
özcan	w
özlem	w
ülkü	w
ünal	m
şeyma	w